datetime,lead_changes,a_team,h_team,w_l,h_pts,a_pts,mp,fg,fga,fg_pct,fg2,fg2a,fg2_pct,fg3,fg3a,fg3_pct,ft,fta,ft_pct,opp_fg,opp_fga,opp_fg_pct,opp_fg2,opp_fg2a,opp_fg2_pct,opp_fg3,opp_fg3a,opp_fg3_pct,opp_ft,opp_fta,opp_ft_pct
4/11/2018,3,BOS,BRK,W ,110,97,240,46,102,0.451,40,78,0.513,6,24,0.25,12,15,0.8,37,91,0.407,26,51,0.51,11,40,0.275,12,16,0.75
4/11/2018,1,CHI,DET,L ,87,119,240,32,86,0.372,21,52,0.404,11,34,0.324,12,18,0.667,47,89,0.528,32,54,0.593,15,35,0.429,10,10,1
4/11/2018,2,CLE,NYK,L ,98,110,240,37,94,0.394,31,70,0.443,6,24,0.25,18,28,0.643,43,85,0.506,31,58,0.534,12,27,0.444,12,13,0.923
4/11/2018,7,LAC,LAL,L ,100,115,240,41,83,0.494,35,65,0.538,6,18,0.333,12,28,0.429,42,88,0.477,25,49,0.51,17,39,0.436,14,16,0.875
4/11/2018,25,MIA,TOR,W ,116,109,265,46,106,0.434,35,80,0.438,11,26,0.423,13,20,0.65,42,92,0.457,33,62,0.532,9,30,0.3,16,21,0.762
4/11/2018,8,MIN,DEN,W ,112,106,265,42,89,0.472,33,66,0.5,9,23,0.391,19,25,0.76,41,90,0.456,28,58,0.483,13,32,0.406,11,18,0.611
4/11/2018,1,NOP,SAS,W ,122,98,240,52,88,0.591,47,69,0.681,5,19,0.263,13,19,0.684,37,92,0.402,29,68,0.426,8,24,0.333,16,19,0.842
4/11/2018,2,OKC,MEM,W ,137,123,240,47,85,0.553,27,42,0.643,20,43,0.465,23,32,0.719,44,91,0.484,31,60,0.517,13,31,0.419,22,24,0.917
4/11/2018,13,ORL,WAS,W ,101,92,240,33,77,0.429,20,45,0.444,13,32,0.406,22,27,0.815,33,95,0.347,23,61,0.377,10,34,0.294,16,27,0.593
4/11/2018,0,PHI,MIL,W ,130,95,240,52,105,0.495,37,69,0.536,15,36,0.417,11,15,0.733,37,90,0.411,30,65,0.462,7,25,0.28,14,16,0.875
4/11/2018,1,POR,UTA,W ,102,93,240,41,89,0.461,32,65,0.492,9,24,0.375,11,16,0.688,33,89,0.371,25,66,0.379,8,23,0.348,19,24,0.792
4/11/2018,10,SAC,HOU,W ,96,83,240,38,80,0.475,31,54,0.574,7,26,0.269,13,20,0.65,31,82,0.378,18,36,0.5,13,46,0.283,8,12,0.667
4/10/2018,8,ATL,PHI,L ,113,121,240,41,98,0.418,28,61,0.459,13,37,0.351,18,26,0.692,43,87,0.494,26,50,0.52,17,37,0.459,18,30,0.6
4/10/2018,9,DAL,PHO,L ,97,124,240,37,97,0.381,29,64,0.453,8,33,0.242,15,22,0.682,48,76,0.632,35,50,0.7,13,26,0.5,15,21,0.714
4/10/2018,1,IND,CHO,L ,93,119,240,40,99,0.404,32,68,0.471,8,31,0.258,5,8,0.625,46,99,0.465,28,57,0.491,18,42,0.429,9,12,0.75
4/10/2018,9,LAL,HOU,L ,99,105,240,38,90,0.422,28,54,0.519,10,36,0.278,13,15,0.867,37,88,0.42,21,41,0.512,16,47,0.34,15,16,0.938
4/10/2018,0,UTA,GSW,W ,119,79,240,48,90,0.533,35,55,0.636,13,35,0.371,10,13,0.769,30,86,0.349,25,67,0.373,5,19,0.263,14,16,0.875
4/10/2018,4,WAS,BOS,W ,113,101,240,41,83,0.494,26,53,0.491,15,30,0.5,16,20,0.8,33,87,0.379,20,54,0.37,13,33,0.394,22,27,0.815
4/9/2018,5,BRK,CHI,W ,114,105,240,41,82,0.5,23,40,0.575,18,42,0.429,14,15,0.933,43,89,0.483,31,61,0.508,12,28,0.429,7,12,0.583
4/9/2018,5,DEN,POR,W ,88,82,240,31,83,0.373,25,57,0.439,6,26,0.231,20,26,0.769,31,94,0.33,24,61,0.393,7,33,0.212,13,18,0.722
4/9/2018,4,DET,TOR,L ,98,108,240,35,78,0.449,26,48,0.542,9,30,0.3,19,25,0.76,46,87,0.529,34,48,0.708,12,39,0.308,4,4,1
4/9/2018,5,LAC,NOP,L ,100,113,240,45,98,0.459,43,81,0.531,2,17,0.118,8,19,0.421,44,95,0.463,33,65,0.508,11,30,0.367,14,20,0.7
4/9/2018,3,MIA,OKC,L ,93,115,240,40,87,0.46,35,65,0.538,5,22,0.227,8,14,0.571,35,81,0.432,21,46,0.457,14,35,0.4,31,38,0.816
4/9/2018,14,MIL,ORL,W ,102,86,240,39,91,0.429,30,65,0.462,9,26,0.346,15,18,0.833,34,82,0.415,29,58,0.5,5,24,0.208,13,20,0.65
4/9/2018,6,MIN,MEM,W ,113,94,240,42,87,0.483,35,65,0.538,7,22,0.318,22,26,0.846,35,85,0.412,30,67,0.448,5,18,0.278,19,21,0.905
4/9/2018,5,NYK,CLE,L ,109,123,240,46,87,0.529,35,57,0.614,11,30,0.367,6,12,0.5,40,85,0.471,21,40,0.525,19,45,0.422,24,28,0.857
4/9/2018,5,SAS,SAC,W ,98,85,240,34,82,0.415,28,55,0.509,6,27,0.222,24,29,0.828,33,81,0.407,25,63,0.397,8,18,0.444,11,17,0.647
4/8/2018,3,BOS,ATL,L ,106,112,240,42,82,0.512,33,59,0.559,9,23,0.391,13,20,0.65,43,86,0.5,28,51,0.549,15,35,0.429,11,14,0.786
4/8/2018,1,CHO,IND,L ,117,123,240,40,80,0.5,29,50,0.58,11,30,0.367,26,30,0.867,50,93,0.538,41,68,0.603,9,25,0.36,14,18,0.778
4/8/2018,0,LAL,UTA,L ,97,112,240,37,93,0.398,32,68,0.471,5,25,0.2,18,22,0.818,42,83,0.506,29,47,0.617,13,36,0.361,15,22,0.682
4/8/2018,1,MEM,DET,W ,130,117,240,48,83,0.578,32,50,0.64,16,33,0.485,18,24,0.75,38,93,0.409,15,46,0.326,23,47,0.489,18,23,0.783
4/8/2018,6,PHI,DAL,W ,109,97,240,46,91,0.505,38,64,0.594,8,27,0.296,9,14,0.643,40,94,0.426,29,54,0.537,11,40,0.275,6,13,0.462
4/8/2018,3,PHO,GSW,L ,100,117,240,39,92,0.424,29,57,0.509,10,35,0.286,12,16,0.75,47,90,0.522,34,58,0.586,13,32,0.406,10,15,0.667
4/8/2018,8,TOR,ORL,W ,112,101,240,39,78,0.5,22,38,0.579,17,40,0.425,17,24,0.708,42,89,0.472,35,66,0.53,7,23,0.304,10,17,0.588
4/7/2018,3,CHI,BRK,L ,96,124,240,36,88,0.409,30,59,0.508,6,29,0.207,18,21,0.857,46,92,0.5,22,37,0.595,24,55,0.436,8,11,0.727
4/7/2018,6,GSW,NOP,L ,120,126,240,49,90,0.544,34,57,0.596,15,33,0.455,7,11,0.636,49,87,0.563,38,60,0.633,11,27,0.407,17,22,0.773
4/7/2018,12,HOU,OKC,L ,102,108,240,36,76,0.474,22,39,0.564,14,37,0.378,16,23,0.696,36,91,0.396,26,58,0.448,10,33,0.303,26,33,0.788
4/7/2018,1,LAC,DEN,L ,115,134,240,43,87,0.494,37,70,0.529,6,17,0.353,23,34,0.676,53,85,0.624,41,56,0.732,12,29,0.414,16,23,0.696
4/7/2018,13,NYK,MIL,L ,102,115,240,41,95,0.432,32,74,0.432,9,21,0.429,11,11,1,45,93,0.484,35,68,0.515,10,25,0.4,15,17,0.882
4/7/2018,11,SAS,POR,W ,116,105,240,47,84,0.56,40,63,0.635,7,21,0.333,15,21,0.714,42,88,0.477,31,60,0.517,11,28,0.393,10,11,0.909
4/6/2018,18,BOS,CHI,W ,111,104,240,45,81,0.556,31,47,0.66,14,34,0.412,7,17,0.412,40,86,0.465,26,56,0.464,14,30,0.467,10,17,0.588
4/6/2018,20,DET,DAL,W ,113,106,265,46,92,0.5,34,62,0.548,12,30,0.4,9,17,0.529,40,92,0.435,27,53,0.509,13,39,0.333,13,18,0.722
4/6/2018,12,LAL,MIN,L ,96,113,240,31,79,0.392,23,55,0.418,8,24,0.333,26,32,0.813,43,100,0.43,35,74,0.473,8,26,0.308,19,26,0.731
4/6/2018,18,MEM,SAC,L ,93,94,240,37,84,0.44,31,60,0.517,6,24,0.25,13,18,0.722,40,85,0.471,34,61,0.557,6,24,0.25,8,12,0.667
4/6/2018,2,NYK,MIA,W ,122,98,240,45,89,0.506,27,52,0.519,18,37,0.486,14,21,0.667,35,88,0.398,28,61,0.459,7,27,0.259,21,22,0.955
4/6/2018,2,ORL,CHO,L ,100,137,240,42,94,0.447,33,71,0.465,9,23,0.391,7,13,0.538,48,86,0.558,31,55,0.564,17,31,0.548,24,26,0.923
4/6/2018,1,PHI,CLE,W ,132,130,240,50,101,0.495,36,62,0.581,14,39,0.359,18,21,0.857,45,87,0.517,29,53,0.547,16,34,0.471,24,33,0.727
4/6/2018,1,PHO,NOP,L ,103,122,240,37,94,0.394,28,61,0.459,9,33,0.273,20,26,0.769,45,99,0.455,29,61,0.475,16,38,0.421,16,20,0.8
4/6/2018,0,TOR,IND,W ,92,73,240,36,84,0.429,27,54,0.5,9,30,0.3,11,16,0.688,26,87,0.299,19,66,0.288,7,21,0.333,14,20,0.7
4/6/2018,19,WAS,ATL,L ,97,103,240,35,87,0.402,26,62,0.419,9,25,0.36,18,23,0.783,38,79,0.481,27,46,0.587,11,33,0.333,16,23,0.696
4/5/2018,6,CLE,WAS,W ,119,115,240,42,77,0.545,29,50,0.58,13,27,0.481,22,28,0.786,47,94,0.5,38,73,0.521,9,21,0.429,12,14,0.857
4/5/2018,12,DEN,MIN,W ,100,96,240,35,89,0.393,24,53,0.453,11,36,0.306,19,22,0.864,39,91,0.429,33,67,0.493,6,24,0.25,12,16,0.75
4/5/2018,4,HOU,POR,W ,96,94,240,34,73,0.466,21,36,0.583,13,37,0.351,15,24,0.625,39,85,0.459,32,63,0.508,7,22,0.318,9,14,0.643
4/5/2018,7,IND,GSW,W ,126,106,240,50,93,0.538,35,64,0.547,15,29,0.517,11,15,0.733,37,83,0.446,28,54,0.519,9,29,0.31,23,24,0.958
4/5/2018,11,MIL,BRK,L ,111,119,240,41,93,0.441,36,73,0.493,5,20,0.25,24,30,0.8,41,75,0.547,22,36,0.611,19,39,0.487,18,21,0.857
4/5/2018,0,UTA,LAC,W ,117,95,240,44,83,0.53,34,56,0.607,10,27,0.37,19,28,0.679,35,79,0.443,32,62,0.516,3,17,0.176,22,28,0.786
4/4/2018,9,ATL,MIA,L ,86,115,240,33,90,0.367,24,60,0.4,9,30,0.3,11,17,0.647,42,94,0.447,25,56,0.446,17,38,0.447,14,17,0.824
4/4/2018,9,DET,PHI,L ,108,115,240,39,88,0.443,23,52,0.442,16,36,0.444,14,23,0.609,44,89,0.494,31,59,0.525,13,30,0.433,14,19,0.737
4/4/2018,17,LAL,SAS,W ,122,112,265,47,86,0.547,34,62,0.548,13,24,0.542,15,18,0.833,42,97,0.433,33,74,0.446,9,23,0.391,19,27,0.704
4/4/2018,0,NOP,MEM,W ,123,95,240,45,86,0.523,29,50,0.58,16,36,0.444,17,19,0.895,37,93,0.398,27,61,0.443,10,32,0.313,11,15,0.733
4/4/2018,4,ORL,DAL,W ,105,100,240,39,86,0.453,31,57,0.544,8,29,0.276,19,27,0.704,39,89,0.438,29,59,0.492,10,30,0.333,12,17,0.706
4/4/2018,8,TOR,BOS,W ,96,78,240,40,92,0.435,30,59,0.508,10,33,0.303,6,8,0.75,25,75,0.333,22,53,0.415,3,22,0.136,25,28,0.893
4/3/2018,11,CHI,CHO,W ,120,114,240,46,99,0.465,31,65,0.477,15,34,0.441,13,18,0.722,40,81,0.494,27,47,0.574,13,34,0.382,21,28,0.75
4/3/2018,5,CLE,TOR,W ,112,106,240,38,77,0.494,25,47,0.532,13,30,0.433,23,26,0.885,42,94,0.447,31,60,0.517,11,34,0.324,11,14,0.786
4/3/2018,14,DAL,POR,W ,115,109,240,42,92,0.457,25,48,0.521,17,44,0.386,14,20,0.7,39,87,0.448,29,47,0.617,10,40,0.25,21,24,0.875
4/3/2018,2,DEN,IND,W ,107,104,240,41,89,0.461,31,57,0.544,10,32,0.313,15,20,0.75,41,84,0.488,32,65,0.492,9,19,0.474,13,16,0.813
4/3/2018,0,HOU,WAS,W ,120,104,240,43,84,0.512,27,38,0.711,16,46,0.348,18,27,0.667,38,72,0.528,26,47,0.553,12,25,0.48,16,23,0.696
4/3/2018,5,LAC,SAS,W ,113,110,240,37,82,0.451,32,66,0.485,5,16,0.313,34,43,0.791,39,88,0.443,31,64,0.484,8,24,0.333,24,28,0.857
4/3/2018,11,MIA,ATL,W ,101,98,240,41,91,0.451,33,58,0.569,8,33,0.242,11,13,0.846,37,88,0.42,24,55,0.436,13,33,0.394,11,15,0.733
4/3/2018,4,MIL,BOS,W ,106,102,240,43,79,0.544,38,59,0.644,5,20,0.25,15,21,0.714,38,81,0.469,31,58,0.534,7,23,0.304,19,24,0.792
4/3/2018,10,NYK,ORL,L ,73,97,240,30,86,0.349,26,59,0.441,4,27,0.148,9,12,0.75,37,88,0.42,26,52,0.5,11,36,0.306,12,18,0.667
4/3/2018,3,OKC,GSW,L ,107,111,240,35,93,0.376,26,55,0.473,9,38,0.237,28,37,0.757,41,83,0.494,33,54,0.611,8,29,0.276,21,24,0.875
4/3/2018,5,PHI,BRK,W ,121,95,240,50,91,0.549,41,70,0.586,9,21,0.429,12,18,0.667,34,81,0.42,17,39,0.436,17,42,0.405,10,23,0.435
4/3/2018,2,PHO,SAC,W ,97,94,240,35,77,0.455,29,60,0.483,6,17,0.353,21,33,0.636,33,89,0.371,22,62,0.355,11,27,0.407,17,23,0.739
4/3/2018,3,UTA,LAL,W ,117,110,240,43,89,0.483,29,56,0.518,14,33,0.424,17,27,0.63,36,74,0.486,22,46,0.478,14,28,0.5,24,36,0.667
4/1/2018,5,ATL,ORL,W ,94,88,240,41,85,0.482,30,49,0.612,11,36,0.306,1,1,1,33,96,0.344,23,60,0.383,10,36,0.278,12,13,0.923
4/1/2018,7,BRK,DET,L ,96,108,240,37,87,0.425,25,44,0.568,12,43,0.279,10,15,0.667,38,84,0.452,31,65,0.477,7,19,0.368,25,32,0.781
4/1/2018,1,CHI,WAS,W ,113,94,240,43,82,0.524,25,48,0.521,18,34,0.529,9,13,0.692,37,81,0.457,29,51,0.569,8,30,0.267,12,12,1
4/1/2018,3,CHO,PHI,L ,102,119,240,33,82,0.402,24,52,0.462,9,30,0.3,27,34,0.794,48,94,0.511,34,62,0.548,14,32,0.438,9,10,0.9
4/1/2018,10,CLE,DAL,W ,98,87,240,35,85,0.412,24,59,0.407,11,26,0.423,17,23,0.739,32,79,0.405,19,42,0.452,13,37,0.351,10,11,0.909
4/1/2018,8,DEN,MIL,W ,128,125,265,40,90,0.444,29,54,0.537,11,36,0.306,37,46,0.804,45,100,0.45,33,67,0.493,12,33,0.364,23,27,0.852
4/1/2018,7,GSW,PHO,W ,117,107,240,48,89,0.539,35,61,0.574,13,28,0.464,8,9,0.889,41,90,0.456,30,59,0.508,11,31,0.355,14,16,0.875
4/1/2018,3,LAC,IND,L ,104,111,240,42,82,0.512,33,57,0.579,9,25,0.36,11,14,0.786,42,86,0.488,31,58,0.534,11,28,0.393,16,21,0.762
4/1/2018,17,LAL,SAC,L ,83,84,240,30,75,0.4,23,43,0.535,7,32,0.219,16,25,0.64,35,92,0.38,28,68,0.412,7,24,0.292,7,14,0.5
4/1/2018,1,MIN,UTA,L ,97,121,240,38,90,0.422,30,66,0.455,8,24,0.333,13,14,0.929,46,76,0.605,35,48,0.729,11,28,0.393,18,25,0.72
4/1/2018,3,NOP,OKC,L ,104,109,240,38,83,0.458,27,51,0.529,11,32,0.344,17,23,0.739,41,95,0.432,32,64,0.5,9,31,0.29,18,25,0.72
4/1/2018,3,POR,MEM,W ,113,98,240,39,84,0.464,27,46,0.587,12,38,0.316,23,25,0.92,40,88,0.455,31,67,0.463,9,21,0.429,9,12,0.75
4/1/2018,4,SAS,HOU,W ,100,83,240,40,81,0.494,34,64,0.531,6,17,0.353,14,21,0.667,26,77,0.338,19,46,0.413,7,31,0.226,24,29,0.828
3/31/2018,15,BOS,TOR,W ,110,99,240,40,88,0.455,33,71,0.465,7,17,0.412,23,27,0.852,37,80,0.463,29,45,0.644,8,35,0.229,17,22,0.773
3/31/2018,13,MIA,BRK,L ,109,110,265,43,95,0.453,36,78,0.462,7,17,0.412,16,21,0.762,39,91,0.429,29,56,0.518,10,35,0.286,22,28,0.786
3/31/2018,9,NYK,DET,L ,109,115,240,43,91,0.473,30,62,0.484,13,29,0.448,10,12,0.833,44,85,0.518,34,61,0.557,10,24,0.417,17,22,0.773
3/31/2018,2,SAC,GSW,L ,96,112,240,36,87,0.414,28,59,0.475,8,28,0.286,16,19,0.842,41,83,0.494,32,57,0.561,9,26,0.346,21,28,0.75
3/31/2018,8,WAS,CHO,W ,107,93,240,40,88,0.455,22,49,0.449,18,39,0.462,9,12,0.75,35,77,0.455,29,54,0.537,6,23,0.261,17,27,0.63
3/30/2018,10,ATL,PHI,L ,91,101,240,36,101,0.356,27,62,0.435,9,39,0.231,10,15,0.667,42,95,0.442,34,57,0.596,8,38,0.211,9,13,0.692
3/30/2018,6,CLE,NOP,W ,107,102,240,43,90,0.478,33,66,0.5,10,24,0.417,11,15,0.733,43,89,0.483,32,63,0.508,11,26,0.423,5,6,0.833
3/30/2018,3,DAL,MIN,L ,92,93,240,38,86,0.442,27,58,0.466,11,28,0.393,5,7,0.714,35,83,0.422,27,58,0.466,8,25,0.32,15,17,0.882
3/30/2018,3,HOU,PHO,W ,104,103,240,35,81,0.432,21,43,0.488,14,38,0.368,20,29,0.69,41,84,0.488,29,52,0.558,12,32,0.375,9,13,0.692
3/30/2018,8,LAL,MIL,L ,122,124,265,48,94,0.511,40,67,0.597,8,27,0.296,18,25,0.72,45,94,0.479,34,65,0.523,11,29,0.379,23,28,0.821
3/30/2018,15,OKC,DEN,L ,125,126,265,45,108,0.417,25,64,0.391,20,44,0.455,15,27,0.556,49,94,0.521,39,64,0.609,10,30,0.333,18,21,0.857
3/30/2018,3,ORL,CHI,L ,82,90,240,31,94,0.33,24,55,0.436,7,39,0.179,13,14,0.929,30,84,0.357,16,43,0.372,14,41,0.341,16,23,0.696
3/30/2018,5,POR,LAC,W ,105,96,240,41,95,0.432,33,65,0.508,8,30,0.267,15,16,0.938,36,89,0.404,32,76,0.421,4,13,0.308,20,35,0.571
3/30/2018,2,UTA,MEM,W ,107,97,240,40,74,0.541,28,43,0.651,12,31,0.387,15,26,0.577,39,81,0.481,30,58,0.517,9,23,0.391,10,15,0.667
3/29/2018,4,DET,WAS,W ,103,92,240,41,84,0.488,35,63,0.556,6,21,0.286,15,20,0.75,37,89,0.416,31,57,0.544,6,32,0.188,12,15,0.8
3/29/2018,6,GSW,MIL,L ,107,116,240,41,75,0.547,31,55,0.564,10,20,0.5,15,15,1,48,87,0.552,37,67,0.552,11,20,0.55,9,10,0.9
3/29/2018,2,MIA,CHI,W ,103,92,240,37,82,0.451,30,55,0.545,7,27,0.259,22,24,0.917,33,90,0.367,27,64,0.422,6,26,0.231,20,26,0.769
3/29/2018,8,SAC,IND,L ,103,106,240,42,78,0.538,29,47,0.617,13,31,0.419,6,9,0.667,40,80,0.5,32,54,0.593,8,26,0.308,18,20,0.9
3/29/2018,10,SAS,OKC,W ,103,99,240,34,81,0.42,21,50,0.42,13,31,0.419,22,30,0.733,37,85,0.435,26,55,0.473,11,30,0.367,14,21,0.667
3/28/2018,5,CHO,CLE,L ,105,118,240,39,76,0.513,34,55,0.618,5,21,0.238,22,24,0.917,45,93,0.484,34,65,0.523,11,28,0.393,17,20,0.85
3/28/2018,12,LAL,DAL,W ,103,93,240,36,77,0.468,27,44,0.614,9,33,0.273,22,32,0.688,33,84,0.393,20,40,0.5,13,44,0.295,14,19,0.737
3/28/2018,6,MEM,POR,W ,108,103,240,41,84,0.488,28,59,0.475,13,25,0.52,13,23,0.565,38,79,0.481,30,49,0.612,8,30,0.267,19,30,0.633
3/28/2018,1,MIN,ATL,W ,126,114,240,48,90,0.533,35,60,0.583,13,30,0.433,17,21,0.81,41,77,0.532,28,50,0.56,13,27,0.481,19,23,0.826
3/28/2018,0,ORL,BRK,L ,104,111,240,40,92,0.435,29,61,0.475,11,31,0.355,13,16,0.813,40,87,0.46,28,53,0.528,12,34,0.353,19,22,0.864
3/28/2018,6,PHI,NYK,W ,118,101,240,45,98,0.459,36,67,0.537,9,31,0.29,19,27,0.704,36,94,0.383,27,63,0.429,9,31,0.29,20,26,0.769
3/28/2018,12,PHO,LAC,L ,99,111,240,38,88,0.432,28,54,0.519,10,34,0.294,13,18,0.722,43,80,0.538,35,63,0.556,8,17,0.471,17,25,0.68
3/28/2018,5,UTA,BOS,L ,94,97,240,34,82,0.415,25,49,0.51,9,33,0.273,17,21,0.81,35,79,0.443,23,58,0.397,12,21,0.571,15,20,0.75
3/27/2018,5,GSW,IND,L ,81,92,240,35,86,0.407,30,69,0.435,5,17,0.294,6,9,0.667,39,81,0.481,33,60,0.55,6,21,0.286,8,12,0.667
3/27/2018,1,HOU,CHI,W ,118,86,240,41,93,0.441,23,36,0.639,18,57,0.316,18,21,0.857,34,89,0.382,26,52,0.5,8,37,0.216,10,17,0.588
3/27/2018,3,LAC,MIL,W ,105,98,240,40,86,0.465,25,58,0.431,15,28,0.536,10,18,0.556,38,83,0.458,32,60,0.533,6,23,0.261,16,23,0.696
3/27/2018,4,MIA,CLE,W ,98,79,240,37,78,0.474,28,49,0.571,9,29,0.31,15,20,0.75,31,85,0.365,27,59,0.458,4,26,0.154,13,19,0.684
3/27/2018,9,NOP,POR,L ,103,107,240,43,94,0.457,39,70,0.557,4,24,0.167,13,14,0.929,44,105,0.419,34,73,0.466,10,32,0.313,9,10,0.9
3/27/2018,1,SAC,DAL,L ,97,103,240,38,93,0.409,32,70,0.457,6,23,0.261,15,19,0.789,36,80,0.45,22,40,0.55,14,40,0.35,17,25,0.68
3/27/2018,14,TOR,DEN,W ,114,110,240,47,92,0.511,34,58,0.586,13,34,0.382,7,9,0.778,42,89,0.472,29,59,0.492,13,30,0.433,13,14,0.929
3/27/2018,10,WAS,SAS,W ,116,106,240,46,85,0.541,36,61,0.59,10,24,0.417,14,18,0.778,39,87,0.448,29,62,0.468,10,25,0.4,18,33,0.545
3/26/2018,7,CHO,NYK,W ,137,128,265,51,93,0.548,40,65,0.615,11,28,0.393,24,28,0.857,54,105,0.514,45,75,0.6,9,30,0.3,11,11,1
3/26/2018,12,DET,LAL,W ,112,106,240,44,100,0.44,31,67,0.463,13,33,0.394,11,15,0.733,40,85,0.471,34,62,0.548,6,23,0.261,20,25,0.8
3/26/2018,13,MIN,MEM,L ,93,101,240,33,79,0.418,25,55,0.455,8,24,0.333,19,24,0.792,40,84,0.476,25,53,0.472,15,31,0.484,6,9,0.667
3/26/2018,1,PHI,DEN,W ,123,104,240,46,91,0.505,33,62,0.532,13,29,0.448,18,25,0.72,36,84,0.429,25,52,0.481,11,32,0.344,21,34,0.618
3/26/2018,5,PHO,BOS,L ,94,102,240,36,81,0.444,24,46,0.522,12,35,0.343,10,19,0.526,37,87,0.425,23,58,0.397,14,29,0.483,14,14,1
3/25/2018,13,BRK,CLE,L ,114,121,240,38,83,0.458,21,46,0.457,17,37,0.459,21,26,0.808,44,87,0.506,32,59,0.542,12,28,0.429,21,26,0.808
3/25/2018,1,GSW,UTA,L ,91,110,240,38,91,0.418,32,76,0.421,6,15,0.4,9,10,0.9,42,87,0.483,30,59,0.508,12,28,0.429,14,18,0.778
3/25/2018,0,HOU,ATL,W ,118,99,240,44,90,0.489,24,38,0.632,20,52,0.385,10,11,0.909,39,88,0.443,28,48,0.583,11,40,0.275,10,11,0.909
3/25/2018,13,IND,MIA,W ,113,107,265,44,90,0.489,36,67,0.537,8,23,0.348,17,21,0.81,41,86,0.477,27,51,0.529,14,35,0.4,11,14,0.786
3/25/2018,4,MIL,SAS,W ,106,103,240,42,86,0.488,33,59,0.559,9,27,0.333,13,18,0.722,41,92,0.446,37,75,0.493,4,17,0.235,17,21,0.81
3/25/2018,14,OKC,POR,L ,105,108,240,37,84,0.44,29,57,0.509,8,27,0.296,23,28,0.821,42,90,0.467,33,56,0.589,9,34,0.265,15,19,0.789
3/25/2018,8,SAC,BOS,L ,93,104,240,38,82,0.463,31,56,0.554,7,26,0.269,10,10,1,40,72,0.556,28,50,0.56,12,22,0.545,12,17,0.706
3/25/2018,7,TOR,LAC,L ,106,117,240,41,92,0.446,25,56,0.446,16,36,0.444,8,14,0.571,44,95,0.463,36,77,0.468,8,18,0.444,21,27,0.778
3/25/2018,11,WAS,NYK,L ,97,101,240,37,87,0.425,31,68,0.456,6,19,0.316,17,23,0.739,41,88,0.466,35,66,0.53,6,22,0.273,13,15,0.867
3/24/2018,7,DAL,CHO,L ,98,102,240,36,91,0.396,24,50,0.48,12,41,0.293,14,19,0.737,35,92,0.38,23,67,0.343,12,25,0.48,20,29,0.69
3/24/2018,0,DET,CHI,W ,117,95,240,43,87,0.494,27,45,0.6,16,42,0.381,15,18,0.833,39,97,0.402,28,62,0.452,11,35,0.314,6,9,0.667
3/24/2018,0,HOU,NOP,W ,114,91,240,45,93,0.484,27,46,0.587,18,47,0.383,6,8,0.75,38,96,0.396,32,75,0.427,6,21,0.286,9,12,0.75
3/24/2018,2,MEM,LAL,L ,93,100,240,35,84,0.417,30,55,0.545,5,29,0.172,18,22,0.818,35,86,0.407,22,48,0.458,13,38,0.342,17,25,0.68
3/24/2018,4,ORL,PHO,W ,105,99,240,37,84,0.44,26,54,0.481,11,30,0.367,20,27,0.741,36,89,0.404,29,60,0.483,7,29,0.241,20,26,0.769
3/24/2018,5,PHI,MIN,W ,120,108,240,42,88,0.477,29,51,0.569,13,37,0.351,23,36,0.639,37,96,0.385,31,73,0.425,6,23,0.261,28,38,0.737
3/23/2018,8,CHI,MIL,L ,105,118,240,36,87,0.414,24,61,0.393,12,26,0.462,21,23,0.913,43,87,0.494,28,57,0.491,15,30,0.5,17,19,0.895
3/23/2018,2,CLE,PHO,W ,120,95,240,47,95,0.495,39,66,0.591,8,29,0.276,18,24,0.75,38,87,0.437,31,59,0.525,7,28,0.25,12,20,0.6
3/23/2018,4,GSW,ATL,W ,106,94,240,42,93,0.452,30,63,0.476,12,30,0.4,10,11,0.909,37,84,0.44,26,52,0.5,11,32,0.344,9,20,0.45
3/23/2018,25,IND,LAC,W ,109,104,240,43,93,0.462,32,62,0.516,11,31,0.355,12,14,0.857,42,76,0.553,32,50,0.64,10,26,0.385,10,14,0.714
3/23/2018,6,NYK,MIN,L ,104,108,240,40,92,0.435,28,64,0.438,12,28,0.429,12,17,0.706,35,75,0.467,25,49,0.51,10,26,0.385,28,32,0.875
3/23/2018,8,OKC,MIA,W ,105,99,240,36,84,0.429,28,58,0.483,8,26,0.308,25,33,0.758,34,87,0.391,21,57,0.368,13,30,0.433,18,20,0.9
3/23/2018,8,POR,BOS,L ,100,105,240,40,91,0.44,32,58,0.552,8,33,0.242,12,15,0.8,35,77,0.455,24,59,0.407,11,18,0.611,24,26,0.923
3/23/2018,12,SAS,UTA,W ,124,120,265,47,92,0.511,40,75,0.533,7,17,0.412,23,27,0.852,43,88,0.489,32,60,0.533,11,28,0.393,23,29,0.793
3/23/2018,14,TOR,BRK,W ,116,112,240,41,86,0.477,27,58,0.466,14,28,0.5,20,29,0.69,41,84,0.488,30,57,0.526,11,27,0.407,19,31,0.613
3/23/2018,9,WAS,DEN,L ,100,108,240,38,80,0.475,24,52,0.462,14,28,0.5,10,14,0.714,37,85,0.435,20,51,0.392,17,34,0.5,17,18,0.944
3/22/2018,0,CHO,MEM,W ,140,79,240,49,92,0.533,30,52,0.577,19,40,0.475,23,27,0.852,30,78,0.385,26,60,0.433,4,18,0.222,15,21,0.714
3/22/2018,4,DAL,UTA,L ,112,119,240,42,85,0.494,25,53,0.472,17,32,0.531,11,14,0.786,46,87,0.529,34,58,0.586,12,29,0.414,15,16,0.938
3/22/2018,12,HOU,DET,W ,100,96,265,35,99,0.354,23,48,0.479,12,51,0.235,18,28,0.643,40,95,0.421,34,57,0.596,6,38,0.158,10,19,0.526
3/22/2018,22,NOP,LAL,W ,128,125,240,52,95,0.547,46,71,0.648,6,24,0.25,18,22,0.818,43,87,0.494,26,48,0.542,17,39,0.436,22,28,0.786
3/22/2018,6,ORL,PHI,L ,98,118,240,37,91,0.407,27,58,0.466,10,33,0.303,14,22,0.636,42,89,0.472,27,52,0.519,15,37,0.405,19,24,0.792
3/22/2018,6,SAC,ATL,W ,105,90,240,43,93,0.462,33,72,0.458,10,21,0.476,9,9,1,33,84,0.393,21,48,0.438,12,36,0.333,12,18,0.667
3/21/2018,8,BRK,CHO,L ,105,111,240,39,93,0.419,26,56,0.464,13,37,0.351,14,21,0.667,36,94,0.383,33,78,0.423,3,16,0.188,36,47,0.766
3/21/2018,2,CHI,DEN,L ,102,135,240,39,89,0.438,26,51,0.51,13,38,0.342,11,14,0.786,51,83,0.614,31,48,0.646,20,35,0.571,13,16,0.813
3/21/2018,14,CLE,TOR,W ,132,129,240,47,78,0.603,32,54,0.593,15,24,0.625,23,28,0.821,47,88,0.534,32,54,0.593,15,34,0.441,20,23,0.87
3/21/2018,4,MIA,NYK,W ,119,98,240,45,81,0.556,30,47,0.638,15,34,0.441,14,19,0.737,39,89,0.438,29,58,0.5,10,31,0.323,10,12,0.833
3/21/2018,3,MIL,LAC,L ,120,127,240,50,91,0.549,42,65,0.646,8,26,0.308,12,17,0.706,45,86,0.523,30,56,0.536,15,30,0.5,22,29,0.759
3/21/2018,17,NOP,IND,W ,96,92,240,34,79,0.43,26,56,0.464,8,23,0.348,20,24,0.833,34,93,0.366,27,71,0.38,7,22,0.318,17,18,0.944
3/21/2018,0,PHI,MEM,W ,119,105,240,46,84,0.548,35,53,0.66,11,31,0.355,16,20,0.8,40,99,0.404,31,72,0.431,9,27,0.333,16,20,0.8
3/21/2018,3,SAS,WAS,W ,98,90,240,39,79,0.494,32,56,0.571,7,23,0.304,13,18,0.722,35,83,0.422,27,58,0.466,8,25,0.32,12,16,0.75
3/20/2018,12,BOS,OKC,W ,100,99,240,36,87,0.414,23,51,0.451,13,36,0.361,15,16,0.938,35,85,0.412,25,58,0.431,10,27,0.37,19,29,0.655
3/20/2018,15,MIN,LAC,W ,123,109,240,45,86,0.523,35,61,0.574,10,25,0.4,23,24,0.958,40,93,0.43,32,69,0.464,8,24,0.333,21,26,0.808
3/20/2018,11,NOP,DAL,W ,115,105,240,48,91,0.527,38,66,0.576,10,25,0.4,9,15,0.6,43,90,0.478,33,55,0.6,10,35,0.286,9,11,0.818
3/20/2018,8,ORL,TOR,L ,86,93,240,37,90,0.411,28,65,0.431,9,25,0.36,3,5,0.6,35,77,0.455,21,41,0.512,14,36,0.389,9,17,0.529
3/20/2018,6,PHO,DET,L ,88,115,240,34,90,0.378,27,56,0.482,7,34,0.206,13,20,0.65,43,97,0.443,28,61,0.459,15,36,0.417,14,16,0.875
3/20/2018,17,POR,HOU,L ,111,115,240,40,81,0.494,29,53,0.547,11,28,0.393,20,27,0.741,38,79,0.481,19,43,0.442,19,36,0.528,20,29,0.69
3/20/2018,15,UTA,ATL,L ,94,99,240,33,89,0.371,27,55,0.491,6,34,0.176,22,25,0.88,38,94,0.404,29,61,0.475,9,33,0.273,14,19,0.737
3/19/2018,17,BRK,MEM,W ,118,115,240,36,72,0.5,20,32,0.625,16,40,0.4,30,40,0.75,46,88,0.523,36,65,0.554,10,23,0.435,13,20,0.65
3/19/2018,9,CLE,MIL,W ,124,117,240,43,87,0.494,28,49,0.571,15,38,0.395,23,27,0.852,45,88,0.511,37,57,0.649,8,31,0.258,19,20,0.95
3/19/2018,11,IND,LAL,W ,110,100,240,43,87,0.494,37,66,0.561,6,21,0.286,18,19,0.947,38,86,0.442,30,53,0.566,8,33,0.242,16,23,0.696
3/19/2018,19,MIA,DEN,W ,149,141,290,56,102,0.549,36,66,0.545,20,36,0.556,17,27,0.63,46,100,0.46,28,62,0.452,18,38,0.474,31,37,0.838
3/19/2018,14,NYK,CHI,W ,110,92,240,43,96,0.448,32,61,0.525,11,35,0.314,13,17,0.765,33,92,0.359,30,62,0.484,3,30,0.1,23,31,0.742
3/19/2018,11,PHI,CHO,W ,108,94,240,42,93,0.452,24,49,0.49,18,44,0.409,6,8,0.75,32,84,0.381,26,62,0.419,6,22,0.273,24,30,0.8
3/19/2018,11,SAC,DET,L ,90,106,240,40,88,0.455,34,65,0.523,6,23,0.261,4,9,0.444,37,79,0.468,23,50,0.46,14,29,0.483,18,22,0.818
3/19/2018,2,SAS,GSW,W ,89,75,240,33,82,0.402,25,59,0.424,8,23,0.348,15,21,0.714,30,74,0.405,27,55,0.491,3,19,0.158,12,16,0.75
3/18/2018,5,LAC,POR,L ,109,122,240,40,89,0.449,31,66,0.47,9,23,0.391,20,27,0.741,46,92,0.5,32,63,0.508,14,29,0.483,16,20,0.8
3/18/2018,3,MIN,HOU,L ,120,129,240,45,86,0.523,35,66,0.53,10,20,0.5,20,26,0.769,43,78,0.551,27,43,0.628,16,35,0.457,27,36,0.75
3/18/2018,3,NOP,BOS,W ,108,89,240,41,82,0.5,35,64,0.547,6,18,0.333,20,25,0.8,35,87,0.402,26,61,0.426,9,26,0.346,10,20,0.5
3/18/2018,25,TOR,OKC,L ,125,132,240,46,81,0.568,31,51,0.608,15,30,0.5,18,23,0.783,49,88,0.557,39,67,0.582,10,21,0.476,24,34,0.706
3/17/2018,8,BRK,DAL,W ,114,106,240,43,84,0.512,29,48,0.604,14,36,0.389,14,19,0.737,41,92,0.446,29,70,0.414,12,22,0.545,12,14,0.857
3/17/2018,3,CHI,CLE,L ,109,114,240,41,91,0.451,25,57,0.439,16,34,0.471,11,15,0.733,44,87,0.506,31,50,0.62,13,37,0.351,13,20,0.65
3/17/2018,0,MEM,DEN,W ,101,94,240,33,81,0.407,20,49,0.408,13,32,0.406,22,28,0.786,32,87,0.368,23,54,0.426,9,33,0.273,21,29,0.724
3/17/2018,7,MIL,ATL,W ,122,117,240,41,86,0.477,30,61,0.492,11,25,0.44,29,32,0.906,39,85,0.459,27,49,0.551,12,36,0.333,27,28,0.964
3/17/2018,4,NOP,HOU,L ,101,107,240,41,83,0.494,33,59,0.559,8,24,0.333,11,12,0.917,39,93,0.419,24,52,0.462,15,41,0.366,14,18,0.778
3/17/2018,1,NYK,CHO,W ,124,101,240,49,100,0.49,37,74,0.5,12,26,0.462,14,18,0.778,33,90,0.367,24,57,0.421,9,33,0.273,26,32,0.813
3/17/2018,10,PHO,GSW,L ,109,124,240,39,82,0.476,28,58,0.483,11,24,0.458,20,29,0.69,50,95,0.526,37,64,0.578,13,31,0.419,11,14,0.786
3/17/2018,1,POR,DET,W ,100,87,240,38,87,0.437,30,56,0.536,8,31,0.258,16,18,0.889,31,80,0.388,21,55,0.382,10,25,0.4,15,20,0.75
3/17/2018,4,SAS,MIN,W ,117,101,240,49,96,0.51,43,70,0.614,6,26,0.231,13,14,0.929,39,81,0.481,32,69,0.464,7,12,0.583,16,20,0.8
3/17/2018,14,UTA,SAC,W ,103,97,240,33,74,0.446,27,50,0.54,6,24,0.25,31,38,0.816,37,86,0.43,23,65,0.354,14,21,0.667,9,14,0.643
3/17/2018,3,WAS,IND,W ,109,102,240,40,74,0.541,30,54,0.556,10,20,0.5,19,23,0.826,39,86,0.453,27,62,0.435,12,24,0.5,12,15,0.8
3/16/2018,5,GSW,SAC,L ,93,98,240,34,81,0.42,22,55,0.4,12,26,0.462,13,18,0.722,36,83,0.434,22,52,0.423,14,31,0.452,12,17,0.706
3/16/2018,16,LAL,MIA,L ,91,92,240,32,76,0.421,23,57,0.404,9,19,0.474,18,22,0.818,36,94,0.383,26,58,0.448,10,36,0.278,10,14,0.714
3/16/2018,1,OKC,LAC,W ,121,113,240,46,94,0.489,35,62,0.565,11,32,0.344,18,22,0.818,42,86,0.488,31,60,0.517,11,26,0.423,18,23,0.783
3/16/2018,1,ORL,BOS,L ,83,92,240,34,87,0.391,29,59,0.492,5,28,0.179,10,11,0.909,31,82,0.378,22,56,0.393,9,26,0.346,21,28,0.75
3/16/2018,21,PHI,BRK,W ,120,116,240,43,95,0.453,31,68,0.456,12,27,0.444,22,26,0.846,40,89,0.449,25,59,0.424,15,30,0.5,21,27,0.778
3/16/2018,12,TOR,DAL,W ,122,115,265,43,91,0.473,33,61,0.541,10,30,0.333,26,31,0.839,48,91,0.527,42,69,0.609,6,22,0.273,13,18,0.722
3/15/2018,0,ATL,CHO,L ,117,129,240,42,90,0.467,26,54,0.481,16,36,0.444,17,26,0.654,46,87,0.529,29,54,0.537,17,33,0.515,20,30,0.667
3/15/2018,9,DEN,DET,W ,120,113,240,43,85,0.506,31,57,0.544,12,28,0.429,22,28,0.786,44,92,0.478,30,65,0.462,14,27,0.519,11,17,0.647
3/15/2018,10,HOU,LAC,W ,101,96,240,35,90,0.389,23,49,0.469,12,41,0.293,19,23,0.826,44,97,0.454,40,79,0.506,4,18,0.222,4,8,0.5
3/15/2018,4,IND,TOR,L ,99,106,240,40,93,0.43,33,69,0.478,7,24,0.292,12,17,0.706,35,79,0.443,23,47,0.489,12,32,0.375,24,28,0.857
3/15/2018,19,MEM,CHI,L ,110,111,240,38,87,0.437,25,52,0.481,13,35,0.371,21,25,0.84,35,80,0.438,20,39,0.513,15,41,0.366,26,33,0.788
3/15/2018,12,NYK,PHI,L ,110,118,240,45,87,0.517,40,67,0.597,5,20,0.25,15,24,0.625,41,91,0.451,26,54,0.481,15,37,0.405,21,34,0.618
3/15/2018,14,POR,CLE,W ,113,105,240,43,96,0.448,31,61,0.508,12,35,0.343,15,19,0.789,41,80,0.513,30,47,0.638,11,33,0.333,12,21,0.571
3/15/2018,1,SAS,NOP,W ,98,93,240,37,99,0.374,30,73,0.411,7,26,0.269,17,19,0.895,36,90,0.4,30,74,0.405,6,16,0.375,15,16,0.938
3/15/2018,4,UTA,PHO,W ,116,88,240,42,97,0.433,30,61,0.492,12,36,0.333,20,32,0.625,32,83,0.386,25,67,0.373,7,16,0.438,17,24,0.708
3/14/2018,6,BOS,WAS,L ,124,125,290,48,99,0.485,36,73,0.493,12,26,0.462,16,23,0.696,46,97,0.474,34,65,0.523,12,32,0.375,21,28,0.75
3/14/2018,8,GSW,LAL,W ,117,106,240,44,81,0.543,38,61,0.623,6,20,0.3,23,28,0.821,38,84,0.452,26,46,0.565,12,38,0.316,18,28,0.643
3/14/2018,4,ORL,MIL,W ,126,117,240,44,87,0.506,26,53,0.491,18,34,0.529,20,23,0.87,49,98,0.5,39,74,0.527,10,24,0.417,9,12,0.75
3/14/2018,6,SAC,MIA,W ,123,119,265,48,94,0.511,40,70,0.571,8,24,0.333,19,25,0.76,41,99,0.414,23,56,0.411,18,43,0.419,19,21,0.905
3/13/2018,2,ATL,OKC,L ,107,119,240,37,87,0.425,24,56,0.429,13,31,0.419,20,24,0.833,42,89,0.472,26,54,0.481,16,35,0.457,19,25,0.76
3/13/2018,11,BRK,TOR,L ,102,116,240,35,86,0.407,20,50,0.4,15,36,0.417,17,19,0.895,44,91,0.484,33,60,0.55,11,31,0.355,17,21,0.81
3/13/2018,8,CHI,LAC,L ,106,112,240,43,101,0.426,36,72,0.5,7,29,0.241,13,15,0.867,37,76,0.487,29,47,0.617,8,29,0.276,30,41,0.732
3/13/2018,9,LAL,DEN,W ,112,103,240,40,90,0.444,25,50,0.5,15,40,0.375,17,25,0.68,38,86,0.442,25,46,0.543,13,40,0.325,14,19,0.737
3/13/2018,8,NOP,CHO,W ,119,115,240,52,104,0.5,43,82,0.524,9,22,0.409,6,8,0.75,45,93,0.484,38,67,0.567,7,26,0.269,18,22,0.818
3/13/2018,11,NYK,DAL,L ,97,110,240,40,82,0.488,32,57,0.561,8,25,0.32,9,12,0.75,40,89,0.449,26,54,0.481,14,35,0.4,16,18,0.889
3/13/2018,3,PHI,IND,L ,98,101,240,35,75,0.467,25,45,0.556,10,30,0.333,18,22,0.818,38,95,0.4,33,71,0.465,5,24,0.208,20,25,0.8
3/13/2018,0,PHO,CLE,L ,107,129,240,38,98,0.388,32,66,0.485,6,32,0.188,25,30,0.833,43,87,0.494,26,52,0.5,17,35,0.486,26,30,0.867
3/13/2018,2,SAS,ORL,W ,108,72,240,40,84,0.476,31,65,0.477,9,19,0.474,19,23,0.826,28,82,0.341,21,59,0.356,7,23,0.304,9,9,1
3/13/2018,0,UTA,DET,W ,110,79,240,42,76,0.553,29,42,0.69,13,34,0.382,13,23,0.565,30,80,0.375,25,55,0.455,5,25,0.2,14,19,0.737
3/13/2018,10,WAS,MIN,L ,111,116,240,42,82,0.512,34,62,0.548,8,20,0.4,19,25,0.76,46,87,0.529,39,66,0.591,7,21,0.333,17,19,0.895
3/12/2018,1,HOU,SAS,W ,109,93,240,39,80,0.488,26,36,0.722,13,44,0.295,18,23,0.783,33,81,0.407,22,53,0.415,11,28,0.393,16,23,0.696
3/12/2018,3,MEM,MIL,L ,103,121,240,42,89,0.472,33,62,0.532,9,27,0.333,10,19,0.526,47,81,0.58,35,56,0.625,12,25,0.48,15,22,0.682
3/12/2018,4,OKC,SAC,W ,106,101,240,38,84,0.452,22,48,0.458,16,36,0.444,14,18,0.778,38,93,0.409,26,60,0.433,12,33,0.364,13,16,0.813
3/12/2018,4,POR,MIA,W ,115,99,240,38,83,0.458,24,47,0.511,14,36,0.389,25,30,0.833,39,91,0.429,29,60,0.483,10,31,0.323,11,16,0.688
3/11/2018,1,ATL,CHI,L ,122,129,240,42,82,0.512,23,42,0.548,19,40,0.475,19,22,0.864,48,98,0.49,31,61,0.508,17,37,0.459,16,19,0.842
3/11/2018,9,BOS,IND,L ,97,99,240,34,81,0.42,22,44,0.5,12,37,0.324,17,21,0.81,39,81,0.481,27,59,0.458,12,22,0.545,9,10,0.9
3/11/2018,1,BRK,PHI,L ,97,120,240,33,85,0.388,23,57,0.404,10,28,0.357,21,24,0.875,50,95,0.526,41,69,0.594,9,26,0.346,11,18,0.611
3/11/2018,2,DAL,HOU,L ,82,105,240,33,94,0.351,28,63,0.444,5,31,0.161,11,18,0.611,39,84,0.464,22,39,0.564,17,45,0.378,10,14,0.714
3/11/2018,1,DEN,SAC,W ,130,104,240,50,89,0.562,35,52,0.673,15,37,0.405,15,21,0.714,39,91,0.429,33,60,0.55,6,31,0.194,20,26,0.769
3/11/2018,2,LAL,CLE,W ,127,113,240,48,96,0.5,35,62,0.565,13,34,0.382,18,20,0.9,41,88,0.466,29,57,0.509,12,31,0.387,19,23,0.826
3/11/2018,6,MIN,GSW,W ,109,103,240,44,95,0.463,38,75,0.507,6,20,0.3,15,21,0.714,37,91,0.407,27,55,0.491,10,36,0.278,19,21,0.905
3/11/2018,3,NOP,UTA,L ,99,116,240,41,93,0.441,35,72,0.486,6,21,0.286,11,13,0.846,40,96,0.417,28,64,0.438,12,32,0.375,24,25,0.96
3/11/2018,5,NYK,TOR,L ,106,132,240,40,88,0.455,33,67,0.493,7,21,0.333,19,24,0.792,47,93,0.505,31,58,0.534,16,35,0.457,22,25,0.88
3/10/2018,0,CHO,PHO,W ,122,115,240,44,87,0.506,31,55,0.564,13,32,0.406,21,27,0.778,42,83,0.506,24,51,0.471,18,32,0.563,13,19,0.684
3/10/2018,2,DAL,MEM,W ,114,80,240,37,77,0.481,27,48,0.563,10,29,0.345,30,35,0.857,30,84,0.357,23,66,0.348,7,18,0.389,13,17,0.765
3/10/2018,12,LAC,ORL,W ,113,105,240,41,78,0.526,34,60,0.567,7,18,0.389,24,28,0.857,38,84,0.452,30,60,0.5,8,24,0.333,21,27,0.778
3/10/2018,0,MIA,WAS,W ,129,102,240,52,88,0.591,42,60,0.7,10,28,0.357,15,21,0.714,34,77,0.442,27,57,0.474,7,20,0.35,27,34,0.794
3/10/2018,4,OKC,SAS,W ,104,94,240,39,85,0.459,29,57,0.509,10,28,0.357,16,24,0.667,40,86,0.465,30,66,0.455,10,20,0.5,4,7,0.571
3/9/2018,11,DEN,LAL,W ,125,116,240,42,83,0.506,27,52,0.519,15,31,0.484,26,30,0.867,45,92,0.489,31,57,0.544,14,35,0.4,12,16,0.75
3/9/2018,1,DET,CHI,W ,99,83,240,38,81,0.469,29,54,0.537,9,27,0.333,14,18,0.778,33,93,0.355,24,62,0.387,9,31,0.29,8,10,0.8
3/9/2018,1,IND,ATL,W ,112,87,240,45,91,0.495,31,63,0.492,14,28,0.5,8,10,0.8,34,82,0.415,24,49,0.49,10,33,0.303,9,10,0.9
3/9/2018,4,LAC,CLE,W ,116,102,240,43,89,0.483,32,61,0.525,11,28,0.393,19,30,0.633,39,87,0.448,27,51,0.529,12,36,0.333,12,18,0.667
3/9/2018,9,MEM,UTA,L ,78,95,240,31,83,0.373,25,61,0.41,6,22,0.273,10,14,0.714,33,74,0.446,20,42,0.476,13,32,0.406,16,22,0.727
3/9/2018,2,MIL,NYK,W ,120,112,240,41,73,0.562,33,55,0.6,8,18,0.444,30,39,0.769,47,98,0.48,40,70,0.571,7,28,0.25,11,14,0.786
3/9/2018,2,NOP,WAS,L ,97,116,240,38,82,0.463,32,62,0.516,6,20,0.3,15,18,0.833,46,96,0.479,37,70,0.529,9,26,0.346,15,20,0.75
3/9/2018,4,POR,GSW,W ,125,108,240,44,89,0.494,28,50,0.56,16,39,0.41,21,27,0.778,38,78,0.487,26,50,0.52,12,28,0.429,20,24,0.833
3/9/2018,0,SAC,ORL,W ,94,88,240,36,83,0.434,27,58,0.466,9,25,0.36,13,15,0.867,33,78,0.423,24,49,0.49,9,29,0.31,13,16,0.813
3/9/2018,1,TOR,HOU,W ,108,105,240,41,85,0.482,26,47,0.553,15,38,0.395,11,14,0.786,40,81,0.494,31,54,0.574,9,27,0.333,16,23,0.696
3/8/2018,6,CHO,BRK,L ,111,125,240,41,85,0.482,37,66,0.561,4,19,0.211,25,30,0.833,47,92,0.511,36,60,0.6,11,32,0.344,20,22,0.909
3/8/2018,7,GSW,SAS,W ,110,107,240,41,95,0.432,33,65,0.508,8,30,0.267,20,23,0.87,43,95,0.453,37,73,0.507,6,22,0.273,15,18,0.833
3/8/2018,9,MIA,PHI,W ,108,99,240,42,89,0.472,28,63,0.444,14,26,0.538,10,18,0.556,34,86,0.395,19,49,0.388,15,37,0.405,16,21,0.762
3/8/2018,7,MIN,BOS,L ,109,117,240,44,94,0.468,32,63,0.508,12,31,0.387,9,13,0.692,43,87,0.494,32,55,0.582,11,32,0.344,20,27,0.741
3/8/2018,3,OKC,PHO,W ,115,87,240,42,80,0.525,29,47,0.617,13,33,0.394,18,27,0.667,31,92,0.337,22,55,0.4,9,37,0.243,16,18,0.889
3/7/2018,5,CHI,MEM,W ,119,110,240,42,79,0.532,31,50,0.62,11,29,0.379,24,32,0.75,40,82,0.488,30,53,0.566,10,29,0.345,20,25,0.8
3/7/2018,2,DEN,CLE,L ,108,113,240,42,86,0.488,32,59,0.542,10,27,0.37,14,18,0.778,44,87,0.506,31,58,0.534,13,29,0.448,12,18,0.667
3/7/2018,14,DET,TOR,L ,119,121,265,44,90,0.489,31,64,0.484,13,26,0.5,18,23,0.783,45,101,0.446,33,61,0.541,12,40,0.3,19,21,0.905
3/7/2018,4,IND,UTA,L ,84,104,240,34,88,0.386,31,65,0.477,3,23,0.13,13,17,0.765,41,80,0.513,30,49,0.612,11,31,0.355,11,16,0.688
3/7/2018,14,LAL,ORL,W ,108,107,240,43,88,0.489,32,55,0.582,11,33,0.333,11,12,0.917,42,84,0.5,30,56,0.536,12,28,0.429,11,19,0.579
3/7/2018,8,MIL,HOU,L ,99,110,240,38,83,0.458,29,55,0.527,9,28,0.321,14,19,0.737,39,82,0.476,25,42,0.595,14,40,0.35,18,27,0.667
3/7/2018,7,SAC,NOP,L ,101,114,240,39,93,0.419,30,65,0.462,9,28,0.321,14,17,0.824,47,83,0.566,36,57,0.632,11,26,0.423,9,9,1
3/6/2018,9,CHO,PHI,L ,114,128,240,40,80,0.5,29,51,0.569,11,29,0.379,23,31,0.742,50,87,0.575,34,54,0.63,16,33,0.485,12,15,0.8
3/6/2018,7,DAL,DEN,W ,118,107,240,43,90,0.478,28,63,0.444,15,27,0.556,17,23,0.739,38,92,0.413,27,56,0.482,11,36,0.306,20,26,0.769
3/6/2018,17,GSW,BRK,W ,114,101,240,47,83,0.566,36,60,0.6,11,23,0.478,9,11,0.818,36,85,0.424,27,51,0.529,9,34,0.265,20,25,0.8
3/6/2018,6,LAC,NOP,L ,116,121,240,46,99,0.465,39,72,0.542,7,27,0.259,17,26,0.654,46,103,0.447,33,73,0.452,13,30,0.433,16,18,0.889
3/6/2018,8,OKC,HOU,L ,112,122,240,46,93,0.495,34,59,0.576,12,34,0.353,8,11,0.727,38,72,0.528,21,39,0.538,17,33,0.515,29,34,0.853
3/6/2018,3,POR,NYK,W ,111,87,240,35,81,0.432,15,48,0.313,20,33,0.606,21,24,0.875,35,83,0.422,28,64,0.438,7,19,0.368,10,15,0.667
3/6/2018,17,TOR,ATL,W ,106,90,240,34,88,0.386,24,52,0.462,10,36,0.278,28,33,0.848,34,80,0.425,28,59,0.475,6,21,0.286,16,21,0.762
3/6/2018,2,WAS,MIA,W ,117,113,265,40,80,0.5,26,56,0.464,14,24,0.583,23,27,0.852,42,94,0.447,33,61,0.541,9,33,0.273,20,27,0.741
3/5/2018,0,CHI,BOS,L ,89,105,240,32,81,0.395,20,48,0.417,12,33,0.364,13,20,0.65,41,84,0.488,29,48,0.604,12,36,0.333,11,12,0.917
3/5/2018,4,CLE,DET,W ,112,90,240,43,88,0.489,31,55,0.564,12,33,0.364,14,17,0.824,34,87,0.391,22,53,0.415,12,34,0.353,10,15,0.667
3/5/2018,9,IND,MIL,W ,92,89,240,33,77,0.429,23,60,0.383,10,17,0.588,16,21,0.762,34,76,0.447,27,53,0.509,7,23,0.304,14,16,0.875
3/5/2018,5,LAL,POR,L ,103,108,240,34,87,0.391,23,50,0.46,11,37,0.297,24,31,0.774,35,83,0.422,25,60,0.417,10,23,0.435,28,38,0.737
3/5/2018,2,MIA,PHO,W ,125,103,240,47,92,0.511,35,56,0.625,12,36,0.333,19,23,0.826,42,87,0.483,32,63,0.508,10,24,0.417,9,18,0.5
3/5/2018,18,SAS,MEM,W ,100,98,240,35,76,0.461,29,54,0.537,6,22,0.273,24,31,0.774,42,80,0.525,34,58,0.586,8,22,0.364,6,9,0.667
3/5/2018,10,UTA,ORL,W ,94,80,240,36,73,0.493,26,42,0.619,10,31,0.323,12,18,0.667,29,85,0.341,18,51,0.353,11,34,0.324,11,14,0.786
3/4/2018,24,ATL,PHO,W ,113,112,240,43,94,0.457,26,61,0.426,17,33,0.515,10,12,0.833,46,92,0.5,35,66,0.53,11,26,0.423,9,15,0.6
3/4/2018,4,DAL,NOP,L ,109,126,240,40,90,0.444,30,67,0.448,10,23,0.435,19,25,0.76,49,91,0.538,37,65,0.569,12,26,0.462,16,21,0.762
3/4/2018,4,LAC,BRK,W ,123,120,240,44,84,0.524,34,57,0.596,10,27,0.37,25,30,0.833,40,92,0.435,21,47,0.447,19,45,0.422,21,23,0.913
3/4/2018,1,MIL,PHI,W ,118,110,240,47,95,0.495,37,72,0.514,10,23,0.435,14,22,0.636,39,70,0.557,25,42,0.595,14,28,0.5,18,22,0.818
3/4/2018,4,SAC,NYK,W ,102,99,240,39,86,0.453,26,56,0.464,13,30,0.433,11,11,1,40,88,0.455,34,67,0.507,6,21,0.286,13,18,0.722
3/4/2018,1,TOR,CHO,W ,103,98,240,35,83,0.422,23,42,0.548,12,41,0.293,21,27,0.778,32,85,0.376,27,64,0.422,5,21,0.238,29,35,0.829
3/4/2018,0,WAS,IND,L ,95,98,240,35,83,0.422,25,56,0.446,10,27,0.37,15,19,0.789,34,77,0.442,26,52,0.5,8,25,0.32,22,24,0.917
3/3/2018,6,CLE,DEN,L ,117,126,240,46,88,0.523,37,64,0.578,9,24,0.375,16,21,0.762,47,86,0.547,28,51,0.549,19,35,0.543,13,15,0.867
3/3/2018,12,HOU,BOS,W ,123,120,240,39,87,0.448,20,38,0.526,19,49,0.388,26,30,0.867,44,91,0.484,31,67,0.463,13,24,0.542,19,21,0.905
3/3/2018,3,MIA,DET,W ,105,96,240,37,82,0.451,25,53,0.472,12,29,0.414,19,28,0.679,37,89,0.416,30,65,0.462,7,24,0.292,15,21,0.714
3/3/2018,14,ORL,MEM,W ,107,100,240,36,72,0.5,28,47,0.596,8,25,0.32,27,33,0.818,38,93,0.409,32,71,0.451,6,22,0.273,18,26,0.692
3/3/2018,18,POR,OKC,W ,108,100,240,39,88,0.443,28,55,0.509,11,33,0.333,19,23,0.826,40,91,0.44,34,64,0.531,6,27,0.222,14,21,0.667
3/3/2018,6,SAC,UTA,L ,91,98,240,34,89,0.382,25,59,0.424,9,30,0.3,14,17,0.824,34,82,0.415,23,50,0.46,11,32,0.344,19,29,0.655
3/3/2018,3,SAS,LAL,L ,112,116,240,44,98,0.449,37,68,0.544,7,30,0.233,17,20,0.85,40,92,0.435,25,58,0.431,15,34,0.441,21,27,0.778
3/2/2018,5,ATL,GSW,L ,109,114,240,38,86,0.442,23,51,0.451,15,35,0.429,18,20,0.9,42,79,0.532,31,48,0.646,11,31,0.355,19,22,0.864
3/2/2018,1,CHI,DAL,W ,108,100,240,42,89,0.472,32,62,0.516,10,27,0.37,14,20,0.7,35,84,0.417,22,55,0.4,13,29,0.448,17,21,0.81
3/2/2018,4,LAC,NYK,W ,128,105,240,50,89,0.562,41,64,0.641,9,25,0.36,19,24,0.792,41,89,0.461,30,64,0.469,11,25,0.44,12,16,0.75
3/2/2018,2,MEM,DEN,L ,102,108,240,40,91,0.44,30,64,0.469,10,27,0.37,12,15,0.8,40,73,0.548,34,51,0.667,6,22,0.273,22,26,0.846
3/2/2018,10,MIL,IND,L ,96,103,240,31,81,0.383,22,56,0.393,9,25,0.36,25,32,0.781,37,83,0.446,31,67,0.463,6,16,0.375,23,30,0.767
3/2/2018,6,ORL,DET,W ,115,106,265,44,86,0.512,31,50,0.62,13,36,0.361,14,19,0.737,40,92,0.435,28,63,0.444,12,29,0.414,14,24,0.583
3/2/2018,11,PHI,CHO,W ,110,99,240,41,81,0.506,32,57,0.561,9,24,0.375,19,25,0.76,34,81,0.42,23,57,0.404,11,24,0.458,20,32,0.625
3/2/2018,4,PHO,OKC,L ,116,124,240,46,96,0.479,35,71,0.493,11,25,0.44,13,18,0.722,46,96,0.479,35,62,0.565,11,34,0.324,21,29,0.724
3/2/2018,12,UTA,MIN,W ,116,108,240,40,78,0.513,31,49,0.633,9,29,0.31,27,35,0.771,38,74,0.514,29,57,0.509,9,17,0.529,23,31,0.742
3/2/2018,5,WAS,TOR,L ,95,102,240,36,79,0.456,27,55,0.491,9,24,0.375,14,21,0.667,36,78,0.462,26,45,0.578,10,33,0.303,20,32,0.625
3/1/2018,0,CLE,PHI,L ,97,108,240,36,87,0.414,27,55,0.491,9,32,0.281,16,23,0.696,40,90,0.444,30,60,0.5,10,30,0.333,18,27,0.667
3/1/2018,6,MIA,LAL,L ,113,131,240,46,95,0.484,37,64,0.578,9,31,0.29,12,16,0.75,47,79,0.595,31,50,0.62,16,29,0.552,21,26,0.808
3/1/2018,10,POR,MIN,W ,108,99,240,36,92,0.391,27,62,0.435,9,30,0.3,27,35,0.771,38,85,0.447,34,65,0.523,4,20,0.2,19,21,0.905
3/1/2018,15,SAC,BRK,W ,116,111,265,50,97,0.515,44,83,0.53,6,14,0.429,10,12,0.833,40,96,0.417,23,50,0.46,17,46,0.37,14,17,0.824
2/28/2018,7,ATL,IND,W ,107,102,240,38,87,0.437,29,58,0.5,9,29,0.31,22,27,0.815,38,90,0.422,27,58,0.466,11,32,0.344,15,20,0.75
2/28/2018,0,BOS,CHO,W ,134,106,240,54,87,0.621,42,67,0.627,12,20,0.6,14,15,0.933,42,91,0.462,33,64,0.516,9,27,0.333,13,22,0.591
2/28/2018,13,DAL,OKC,L ,110,111,265,44,91,0.484,31,55,0.564,13,36,0.361,9,15,0.6,42,93,0.452,32,57,0.561,10,36,0.278,17,19,0.895
2/28/2018,6,DET,MIL,W ,110,87,240,42,95,0.442,33,66,0.5,9,29,0.31,17,22,0.773,28,73,0.384,20,49,0.408,8,24,0.333,23,28,0.821
2/28/2018,1,LAC,HOU,L ,92,105,240,36,79,0.456,29,56,0.518,7,23,0.304,13,19,0.684,36,85,0.424,23,42,0.548,13,43,0.302,20,24,0.833
2/28/2018,2,MEM,PHO,L ,102,110,240,33,87,0.379,20,56,0.357,13,31,0.419,23,28,0.821,38,83,0.458,32,62,0.516,6,21,0.286,28,38,0.737
2/28/2018,18,ORL,TOR,L ,104,117,240,39,82,0.476,26,52,0.5,13,30,0.433,13,23,0.565,45,83,0.542,33,53,0.623,12,30,0.4,15,24,0.625
2/28/2018,3,SAS,NOP,L ,116,121,240,48,99,0.485,39,73,0.534,9,26,0.346,11,14,0.786,50,99,0.505,41,73,0.562,9,26,0.346,12,15,0.8
2/28/2018,4,WAS,GSW,L ,101,109,240,36,90,0.4,25,58,0.431,11,32,0.344,18,21,0.857,37,72,0.514,27,48,0.563,10,24,0.417,25,30,0.833
2/27/2018,11,CHO,CHI,W ,118,103,240,44,82,0.537,29,47,0.617,15,35,0.429,15,21,0.714,39,81,0.481,30,57,0.526,9,24,0.375,16,21,0.762
2/27/2018,25,CLE,BRK,W ,129,123,240,50,97,0.515,38,73,0.521,12,24,0.5,17,27,0.63,44,82,0.537,32,50,0.64,12,32,0.375,23,30,0.767
2/27/2018,5,DEN,LAC,L ,120,122,240,43,87,0.494,33,56,0.589,10,31,0.323,24,30,0.8,46,89,0.517,39,63,0.619,7,26,0.269,23,31,0.742
2/27/2018,11,MIA,PHI,W ,102,101,240,36,82,0.439,27,55,0.491,9,27,0.333,21,28,0.75,35,84,0.417,23,53,0.434,12,31,0.387,19,23,0.826
2/27/2018,0,MIL,WAS,L ,104,107,240,35,77,0.455,25,51,0.49,10,26,0.385,24,28,0.857,42,88,0.477,35,68,0.515,7,20,0.35,16,22,0.727
2/27/2018,0,POR,SAC,W ,116,99,240,44,84,0.524,29,50,0.58,15,34,0.441,13,17,0.765,39,88,0.443,32,66,0.485,7,22,0.318,14,15,0.933
2/26/2018,2,ATL,LAL,L ,104,123,240,36,96,0.375,28,60,0.467,8,36,0.222,24,34,0.706,47,90,0.522,32,57,0.561,15,33,0.455,14,19,0.737
2/26/2018,1,BOS,MEM,W ,109,98,240,39,86,0.453,27,49,0.551,12,37,0.324,19,27,0.704,34,78,0.436,29,55,0.527,5,23,0.217,25,32,0.781
2/26/2018,4,BRK,CHI,W ,104,87,240,40,90,0.444,24,48,0.5,16,42,0.381,8,8,1,33,93,0.355,27,70,0.386,6,23,0.261,15,23,0.652
2/26/2018,16,DAL,IND,W ,109,103,240,40,88,0.455,26,51,0.51,14,37,0.378,15,18,0.833,41,87,0.471,36,67,0.537,5,20,0.25,16,23,0.696
2/26/2018,12,NOP,PHO,W ,125,116,240,43,91,0.473,35,63,0.556,8,28,0.286,31,40,0.775,42,97,0.433,35,73,0.479,7,24,0.292,25,32,0.781
2/26/2018,12,NYK,GSW,L ,111,125,240,47,96,0.49,37,71,0.521,10,25,0.4,7,9,0.778,44,85,0.518,29,54,0.537,15,31,0.484,22,26,0.846
2/26/2018,10,OKC,ORL,W ,112,105,240,42,88,0.477,31,63,0.492,11,25,0.44,17,20,0.85,39,84,0.464,27,55,0.491,12,29,0.414,15,21,0.714
2/26/2018,1,SAC,MIN,L ,100,118,240,40,84,0.476,32,62,0.516,8,22,0.364,12,13,0.923,39,76,0.513,32,60,0.533,7,16,0.438,33,36,0.917
2/26/2018,4,TOR,DET,W ,123,94,240,42,80,0.525,25,42,0.595,17,38,0.447,22,23,0.957,36,94,0.383,29,72,0.403,7,22,0.318,15,20,0.75
2/26/2018,5,UTA,HOU,L ,85,96,240,31,71,0.437,24,42,0.571,7,29,0.241,16,22,0.727,34,79,0.43,25,46,0.543,9,33,0.273,19,25,0.76
2/25/2018,1,CHO,DET,W ,114,98,240,42,88,0.477,26,53,0.491,16,35,0.457,14,23,0.609,42,85,0.494,38,67,0.567,4,18,0.222,10,14,0.714
2/25/2018,15,CLE,SAS,L ,94,110,240,38,91,0.418,30,57,0.526,8,34,0.235,10,14,0.714,38,86,0.442,29,67,0.433,9,19,0.474,25,32,0.781
2/25/2018,0,DEN,HOU,L ,114,119,240,44,91,0.484,34,62,0.548,10,29,0.345,16,24,0.667,39,77,0.506,24,42,0.571,15,35,0.429,26,32,0.813
2/25/2018,13,MIL,NOP,L ,121,123,265,44,96,0.458,37,71,0.521,7,25,0.28,26,29,0.897,51,107,0.477,41,77,0.532,10,30,0.333,11,14,0.786
2/25/2018,5,WAS,PHI,W ,109,94,240,43,79,0.544,31,54,0.574,12,25,0.48,11,12,0.917,31,86,0.36,22,53,0.415,9,33,0.273,23,31,0.742
2/24/2018,17,GSW,OKC,W ,112,80,240,42,89,0.472,25,51,0.49,17,38,0.447,11,13,0.846,29,88,0.33,20,54,0.37,9,34,0.265,13,21,0.619
2/24/2018,8,MIA,MEM,W ,115,89,240,41,89,0.461,29,56,0.518,12,33,0.364,21,27,0.778,35,80,0.438,30,69,0.435,5,11,0.455,14,17,0.824
2/24/2018,15,MIN,CHI,W ,122,104,240,46,94,0.489,35,59,0.593,11,35,0.314,19,26,0.731,42,90,0.467,36,67,0.537,6,23,0.261,14,20,0.7
2/24/2018,11,NYK,BOS,L ,112,121,240,45,96,0.469,39,69,0.565,6,27,0.222,16,20,0.8,42,93,0.452,29,60,0.483,13,33,0.394,24,28,0.857
2/24/2018,1,PHI,ORL,W ,116,105,240,42,81,0.519,33,54,0.611,9,27,0.333,23,27,0.852,38,85,0.447,25,54,0.463,13,31,0.419,16,19,0.842
2/24/2018,10,PHO,POR,L ,104,106,240,39,87,0.448,28,61,0.459,11,26,0.423,15,21,0.714,39,99,0.394,33,69,0.478,6,30,0.2,22,30,0.733
2/24/2018,8,SAC,LAL,L ,108,113,240,42,94,0.447,29,69,0.42,13,25,0.52,11,17,0.647,41,91,0.451,24,53,0.453,17,38,0.447,14,20,0.7
2/24/2018,6,UTA,DAL,W ,97,90,240,34,85,0.4,25,53,0.472,9,32,0.281,20,26,0.769,34,83,0.41,24,48,0.5,10,35,0.286,12,14,0.857
2/23/2018,17,DEN,SAS,W ,122,119,240,48,97,0.495,36,65,0.554,12,32,0.375,14,19,0.737,43,85,0.506,38,69,0.551,5,16,0.313,28,39,0.718
2/23/2018,4,DET,BOS,L ,98,110,240,37,85,0.435,27,52,0.519,10,33,0.303,14,21,0.667,41,85,0.482,24,46,0.522,17,39,0.436,11,18,0.611
2/23/2018,8,HOU,MIN,W ,120,102,240,40,83,0.482,26,45,0.578,14,38,0.368,26,30,0.867,40,94,0.426,30,68,0.441,10,26,0.385,12,16,0.75
2/23/2018,0,IND,ATL,W ,116,93,240,48,101,0.475,39,73,0.534,9,28,0.321,11,13,0.846,37,82,0.451,30,51,0.588,7,31,0.226,12,19,0.632
2/23/2018,0,LAL,DAL,W ,124,102,240,48,93,0.516,35,60,0.583,13,33,0.394,15,20,0.75,37,91,0.407,18,49,0.367,19,42,0.452,9,11,0.818
2/23/2018,3,MEM,CLE,L ,89,112,240,33,84,0.393,24,60,0.4,9,24,0.375,14,18,0.778,40,87,0.46,29,58,0.5,11,29,0.379,21,22,0.955
2/23/2018,9,NOP,MIA,W ,124,123,265,48,108,0.444,40,77,0.519,8,31,0.258,20,24,0.833,50,108,0.463,44,90,0.489,6,18,0.333,17,26,0.654
2/23/2018,0,PHO,LAC,L ,117,128,240,45,103,0.437,36,72,0.5,9,31,0.29,18,31,0.581,45,87,0.517,31,55,0.564,14,32,0.438,24,32,0.75
2/23/2018,13,TOR,MIL,L ,119,122,265,43,90,0.478,34,56,0.607,9,34,0.265,24,26,0.923,43,90,0.478,30,64,0.469,13,26,0.5,23,27,0.852
2/23/2018,0,UTA,POR,L ,81,100,240,33,78,0.423,27,53,0.509,6,25,0.24,9,11,0.818,39,87,0.448,30,63,0.476,9,24,0.375,13,14,0.929
2/23/2018,2,WAS,CHO,L ,105,122,240,40,81,0.494,31,56,0.554,9,25,0.36,16,17,0.941,44,90,0.489,27,51,0.529,17,39,0.436,17,20,0.85
2/22/2018,6,CHI,PHI,L ,115,116,240,44,97,0.454,26,63,0.413,18,34,0.529,9,15,0.6,42,82,0.512,31,53,0.585,11,29,0.379,21,35,0.6
2/22/2018,8,CHO,BRK,W ,111,96,240,42,87,0.483,31,66,0.47,11,21,0.524,16,20,0.8,36,93,0.387,22,50,0.44,14,43,0.326,10,14,0.714
2/22/2018,14,CLE,WAS,L ,103,110,240,42,84,0.5,34,49,0.694,8,35,0.229,11,19,0.579,44,92,0.478,32,62,0.516,12,30,0.4,10,10,1
2/22/2018,2,GSW,LAC,W ,134,127,240,47,77,0.61,33,52,0.635,14,25,0.56,26,34,0.765,44,88,0.5,33,56,0.589,11,32,0.344,28,34,0.824
2/22/2018,14,ORL,NYK,L ,113,120,240,43,83,0.518,32,59,0.542,11,24,0.458,16,23,0.696,48,99,0.485,41,74,0.554,7,25,0.28,17,21,0.81
2/22/2018,2,SAC,OKC,L ,107,110,240,42,91,0.462,30,64,0.469,12,27,0.444,11,15,0.733,38,86,0.442,24,51,0.471,14,35,0.4,20,24,0.833
2/15/2018,2,MIL,DEN,L ,123,134,240,49,92,0.533,40,66,0.606,9,26,0.346,16,22,0.727,47,85,0.553,23,45,0.511,24,40,0.6,16,20,0.8
2/15/2018,13,MIN,LAL,W ,119,111,240,42,90,0.467,36,66,0.545,6,24,0.25,29,31,0.935,43,94,0.457,36,63,0.571,7,31,0.226,18,26,0.692
2/14/2018,16,BOS,LAC,L ,119,129,240,42,97,0.433,27,66,0.409,15,31,0.484,20,21,0.952,44,88,0.5,33,59,0.559,11,29,0.379,30,33,0.909
2/14/2018,29,BRK,IND,L ,103,108,240,35,83,0.422,22,48,0.458,13,35,0.371,20,27,0.741,39,90,0.433,33,75,0.44,6,15,0.4,24,28,0.857
2/14/2018,11,CHI,TOR,L ,98,122,240,39,91,0.429,35,67,0.522,4,24,0.167,16,20,0.8,48,92,0.522,34,54,0.63,14,38,0.368,12,15,0.8
2/14/2018,1,DET,ATL,W ,104,98,240,35,83,0.422,22,50,0.44,13,33,0.394,21,25,0.84,38,89,0.427,32,56,0.571,6,33,0.182,16,19,0.842
2/14/2018,6,HOU,SAC,W ,100,91,240,33,83,0.398,19,34,0.559,14,49,0.286,20,22,0.909,38,87,0.437,28,55,0.509,10,32,0.313,5,8,0.625
2/14/2018,14,MEM,OKC,L ,114,121,240,44,86,0.512,30,59,0.508,14,27,0.519,12,15,0.8,40,81,0.494,23,44,0.523,17,37,0.459,24,35,0.686
2/14/2018,0,NOP,LAL,W ,139,117,240,53,99,0.535,39,67,0.582,14,32,0.438,19,21,0.905,46,90,0.511,36,68,0.529,10,22,0.455,15,18,0.833
2/14/2018,8,NYK,WAS,L ,113,118,240,45,97,0.464,36,78,0.462,9,19,0.474,14,18,0.778,48,88,0.545,41,66,0.621,7,22,0.318,15,19,0.789
2/14/2018,8,ORL,CHO,L ,102,104,240,36,86,0.419,21,49,0.429,15,37,0.405,15,17,0.882,38,88,0.432,25,58,0.431,13,30,0.433,15,19,0.789
2/14/2018,6,PHI,MIA,W ,104,102,240,39,92,0.424,30,57,0.526,9,35,0.257,17,25,0.68,35,77,0.455,24,50,0.48,11,27,0.407,21,29,0.724
2/14/2018,2,POR,GSW,W ,123,117,240,45,93,0.484,33,60,0.55,12,33,0.364,21,24,0.875,43,90,0.478,30,53,0.566,13,37,0.351,18,19,0.947
2/14/2018,12,UTA,PHO,W ,107,97,240,39,92,0.424,29,58,0.5,10,34,0.294,19,22,0.864,34,79,0.43,22,50,0.44,12,29,0.414,17,24,0.708
2/13/2018,1,DAL,SAC,L ,109,114,240,38,83,0.458,23,43,0.535,15,40,0.375,18,23,0.783,47,87,0.54,35,58,0.603,12,29,0.414,8,12,0.667
2/13/2018,20,DEN,SAS,W ,117,109,240,46,93,0.495,36,61,0.59,10,32,0.313,15,18,0.833,44,82,0.537,38,60,0.633,6,22,0.273,15,22,0.682
2/13/2018,7,MIL,ATL,W ,97,92,240,38,88,0.432,30,63,0.476,8,25,0.32,13,17,0.765,33,86,0.384,21,51,0.412,12,35,0.343,14,20,0.7
2/13/2018,1,MIN,HOU,L ,108,126,240,40,84,0.476,34,61,0.557,6,23,0.261,22,23,0.957,41,83,0.494,19,36,0.528,22,47,0.468,22,29,0.759
2/13/2018,9,OKC,CLE,L ,112,120,240,40,90,0.444,29,55,0.527,11,35,0.314,21,30,0.7,45,88,0.511,29,52,0.558,16,36,0.444,14,22,0.636
2/13/2018,18,TOR,MIA,W ,115,112,240,42,90,0.467,29,55,0.527,13,35,0.371,18,23,0.783,42,86,0.488,30,57,0.526,12,29,0.414,16,19,0.842
2/12/2018,2,BRK,LAC,L ,101,114,240,41,89,0.461,29,49,0.592,12,40,0.3,7,10,0.7,48,85,0.565,42,69,0.609,6,16,0.375,12,14,0.857
2/12/2018,14,CHI,ORL,W ,105,101,240,40,88,0.455,31,56,0.554,9,32,0.281,16,21,0.762,37,84,0.44,27,53,0.509,10,31,0.323,17,19,0.895
2/12/2018,6,DET,NOP,L ,103,118,240,35,95,0.368,26,60,0.433,9,35,0.257,24,32,0.75,44,100,0.44,30,66,0.455,14,34,0.412,16,16,1
2/12/2018,5,GSW,PHO,W ,129,83,240,52,89,0.584,41,63,0.651,11,26,0.423,14,21,0.667,33,95,0.347,30,72,0.417,3,23,0.13,14,22,0.636
2/12/2018,0,PHI,NYK,W ,108,92,240,41,75,0.547,31,56,0.554,10,19,0.526,16,24,0.667,31,79,0.392,25,55,0.455,6,24,0.25,24,28,0.857
2/12/2018,17,UTA,SAS,W ,101,99,240,35,84,0.417,24,60,0.4,11,24,0.458,20,30,0.667,38,85,0.447,32,60,0.533,6,25,0.24,17,25,0.68
2/11/2018,23,ATL,DET,W ,118,115,240,38,78,0.487,28,49,0.571,10,29,0.345,32,37,0.865,38,83,0.458,25,50,0.5,13,33,0.394,26,33,0.788
2/11/2018,13,BOS,CLE,L ,99,121,240,36,89,0.404,26,51,0.51,10,38,0.263,17,22,0.773,45,84,0.536,29,54,0.537,16,30,0.533,15,20,0.75
2/11/2018,1,CHO,TOR,L ,103,123,240,38,89,0.427,28,66,0.424,10,23,0.435,17,23,0.739,49,87,0.563,31,50,0.62,18,37,0.486,7,10,0.7
2/11/2018,2,HOU,DAL,W ,104,97,240,34,78,0.436,21,33,0.636,13,45,0.289,23,33,0.697,38,93,0.409,28,62,0.452,10,31,0.323,11,16,0.688
2/11/2018,3,IND,NYK,W ,121,113,240,47,94,0.5,35,66,0.53,12,28,0.429,15,22,0.682,41,93,0.441,32,58,0.552,9,35,0.257,22,25,0.88
2/11/2018,10,MIN,SAC,W ,111,106,240,37,74,0.5,28,50,0.56,9,24,0.375,28,32,0.875,42,88,0.477,32,63,0.508,10,25,0.4,12,17,0.706
2/11/2018,1,OKC,MEM,W ,110,92,240,34,77,0.442,18,40,0.45,16,37,0.432,26,40,0.65,32,82,0.39,26,54,0.481,6,28,0.214,22,24,0.917
2/11/2018,4,POR,UTA,L ,96,115,240,33,81,0.407,24,56,0.429,9,25,0.36,21,25,0.84,41,88,0.466,28,62,0.452,13,26,0.5,20,22,0.909
2/10/2018,2,BRK,NOP,L ,128,138,290,43,114,0.377,22,55,0.4,21,59,0.356,21,22,0.955,52,106,0.491,43,82,0.524,9,24,0.375,25,39,0.641
2/10/2018,1,CHI,WAS,L ,90,101,240,34,80,0.425,25,48,0.521,9,32,0.281,13,16,0.813,38,82,0.463,25,44,0.568,13,38,0.342,12,14,0.857
2/10/2018,13,DAL,LAL,W ,130,123,240,48,89,0.539,36,62,0.581,12,27,0.444,22,27,0.815,46,84,0.548,30,50,0.6,16,34,0.471,15,22,0.682
2/10/2018,5,GSW,SAS,W ,122,105,240,48,85,0.565,36,58,0.621,12,27,0.444,14,15,0.933,43,94,0.457,38,67,0.567,5,27,0.185,14,19,0.737
2/10/2018,24,ORL,MIL,L ,104,111,240,37,83,0.446,29,53,0.547,8,30,0.267,22,26,0.846,43,82,0.524,34,57,0.596,9,25,0.36,16,20,0.8
2/10/2018,7,PHI,LAC,W ,112,98,240,43,90,0.478,30,57,0.526,13,33,0.394,13,17,0.765,38,88,0.432,30,56,0.536,8,32,0.25,14,23,0.609
2/10/2018,6,PHO,DEN,L ,113,123,240,46,84,0.548,39,65,0.6,7,19,0.368,14,25,0.56,45,88,0.511,32,59,0.542,13,29,0.448,20,22,0.909
2/9/2018,7,ATL,CLE,L ,107,123,240,37,83,0.446,21,39,0.538,16,44,0.364,17,19,0.895,46,86,0.535,31,51,0.608,15,35,0.429,16,24,0.667
2/9/2018,4,BOS,IND,L ,91,97,240,34,89,0.382,27,62,0.435,7,27,0.259,16,20,0.8,37,83,0.446,32,63,0.508,5,20,0.25,18,22,0.818
2/9/2018,15,CHI,MIN,W ,114,113,240,41,83,0.494,32,57,0.561,9,26,0.346,23,30,0.767,41,87,0.471,33,65,0.508,8,22,0.364,23,28,0.821
2/9/2018,9,DET,LAC,L ,95,108,240,36,88,0.409,26,57,0.456,10,31,0.323,13,17,0.765,42,91,0.462,32,61,0.525,10,30,0.333,14,15,0.933
2/9/2018,0,HOU,DEN,W ,130,104,240,43,86,0.5,24,45,0.533,19,41,0.463,25,34,0.735,42,88,0.477,39,60,0.65,3,28,0.107,17,21,0.81
2/9/2018,3,MIA,MIL,W ,91,85,240,32,88,0.364,22,62,0.355,10,26,0.385,17,18,0.944,32,76,0.421,26,56,0.464,6,20,0.3,15,17,0.882
2/9/2018,0,PHI,NOP,W ,100,82,240,39,93,0.419,25,59,0.424,14,34,0.412,8,9,0.889,33,95,0.347,25,64,0.391,8,31,0.258,8,16,0.5
2/9/2018,15,SAC,POR,L ,100,118,240,38,90,0.422,29,67,0.433,9,23,0.391,15,21,0.714,43,88,0.489,28,53,0.528,15,35,0.429,17,18,0.944
2/9/2018,8,UTA,CHO,W ,106,94,240,41,84,0.488,31,55,0.564,10,29,0.345,14,17,0.824,35,85,0.412,26,61,0.426,9,24,0.375,15,19,0.789
2/8/2018,14,GSW,DAL,W ,121,103,240,45,88,0.511,31,59,0.525,14,29,0.483,17,20,0.85,40,92,0.435,31,55,0.564,9,37,0.243,14,17,0.824
2/8/2018,1,LAL,OKC,W ,106,81,240,42,96,0.438,32,65,0.492,10,31,0.323,12,13,0.923,32,90,0.356,24,56,0.429,8,34,0.235,9,19,0.474
2/8/2018,11,ORL,ATL,W ,100,98,240,36,84,0.429,27,55,0.491,9,29,0.31,19,22,0.864,37,87,0.425,25,57,0.439,12,30,0.4,12,18,0.667
2/8/2018,1,POR,CHO,W ,109,103,265,41,90,0.456,32,59,0.542,9,31,0.29,18,22,0.818,38,98,0.388,25,65,0.385,13,33,0.394,14,17,0.824
2/8/2018,1,TOR,NYK,W ,113,88,240,43,95,0.453,27,52,0.519,16,43,0.372,11,14,0.786,33,83,0.398,26,56,0.464,7,27,0.259,15,18,0.833
2/8/2018,24,WAS,BOS,L ,104,110,265,38,95,0.4,26,69,0.377,12,26,0.462,16,20,0.8,39,84,0.464,30,58,0.517,9,26,0.346,23,34,0.676
2/7/2018,34,CLE,MIN,W ,140,138,265,52,88,0.591,31,47,0.66,21,41,0.512,15,23,0.652,54,93,0.581,35,60,0.583,19,33,0.576,11,12,0.917
2/7/2018,4,DET,BRK,W ,115,106,240,44,92,0.478,35,68,0.515,9,24,0.375,18,25,0.72,39,90,0.433,22,39,0.564,17,51,0.333,11,12,0.917
2/7/2018,0,MEM,UTA,L ,88,92,240,34,81,0.42,26,58,0.448,8,23,0.348,12,16,0.75,29,69,0.42,23,47,0.489,6,22,0.273,28,33,0.848
2/7/2018,9,MIA,HOU,L ,101,109,240,39,88,0.443,26,56,0.464,13,32,0.406,10,12,0.833,38,74,0.514,26,43,0.605,12,31,0.387,21,26,0.808
2/7/2018,0,PHO,SAS,L ,81,129,240,33,97,0.34,30,65,0.462,3,32,0.094,12,18,0.667,46,93,0.495,30,61,0.492,16,32,0.5,21,27,0.778
2/6/2018,1,ATL,MEM,W ,108,82,240,42,83,0.506,34,58,0.586,8,25,0.32,16,21,0.762,34,79,0.43,30,57,0.526,4,22,0.182,10,13,0.769
2/6/2018,6,BRK,HOU,L ,113,123,240,41,85,0.482,25,50,0.5,16,35,0.457,15,17,0.882,45,81,0.556,29,48,0.604,16,33,0.485,17,21,0.81
2/6/2018,0,GSW,OKC,L ,105,125,240,37,76,0.487,29,48,0.604,8,28,0.286,23,31,0.742,44,93,0.473,32,62,0.516,12,31,0.387,25,33,0.758
2/6/2018,9,LAL,PHO,W ,112,93,240,39,83,0.47,28,57,0.491,11,26,0.423,23,26,0.885,36,94,0.383,28,65,0.431,8,29,0.276,13,23,0.565
2/6/2018,13,NYK,MIL,L ,89,103,240,37,89,0.416,32,66,0.485,5,23,0.217,10,15,0.667,37,82,0.451,29,56,0.518,8,26,0.308,21,27,0.778
2/6/2018,7,ORL,CLE,W ,116,98,240,46,88,0.523,40,66,0.606,6,22,0.273,18,27,0.667,36,84,0.429,24,47,0.511,12,37,0.324,14,20,0.7
2/6/2018,0,PHI,WAS,W ,115,102,240,45,82,0.549,31,54,0.574,14,28,0.5,11,14,0.786,41,93,0.441,34,66,0.515,7,27,0.259,13,18,0.722
2/6/2018,5,TOR,BOS,W ,111,91,240,40,80,0.5,23,44,0.523,17,36,0.472,14,17,0.824,33,83,0.398,23,60,0.383,10,23,0.435,15,20,0.75
2/5/2018,4,DEN,CHO,W ,121,104,240,46,81,0.568,28,47,0.596,18,34,0.529,11,13,0.846,39,77,0.506,28,51,0.549,11,26,0.423,15,24,0.625
2/5/2018,1,DET,POR,W ,111,91,240,44,88,0.5,29,58,0.5,15,30,0.5,8,12,0.667,37,94,0.394,27,61,0.443,10,33,0.303,7,8,0.875
2/5/2018,4,IND,WAS,L ,102,111,240,37,80,0.463,25,51,0.49,12,29,0.414,16,25,0.64,45,82,0.549,38,57,0.667,7,25,0.28,14,17,0.824
2/5/2018,8,LAC,DAL,W ,104,101,240,42,87,0.483,32,60,0.533,10,27,0.37,10,12,0.833,33,80,0.413,16,38,0.421,17,42,0.405,18,20,0.9
2/5/2018,9,MIA,ORL,L ,109,111,240,40,93,0.43,37,70,0.529,3,23,0.13,26,35,0.743,41,84,0.488,28,54,0.519,13,30,0.433,16,19,0.842
2/5/2018,1,NOP,UTA,L ,109,133,240,47,93,0.505,39,71,0.549,8,22,0.364,7,13,0.538,52,89,0.584,38,68,0.559,14,21,0.667,15,17,0.882
2/5/2018,3,SAC,CHI,W ,104,98,240,37,84,0.44,26,52,0.5,11,32,0.344,19,25,0.76,32,80,0.4,18,44,0.409,14,36,0.389,20,24,0.833
2/4/2018,4,BOS,POR,W ,97,96,240,35,85,0.412,20,49,0.408,15,36,0.417,12,17,0.706,36,91,0.396,23,60,0.383,13,31,0.419,11,14,0.786
2/4/2018,0,BRK,MIL,L ,94,109,240,37,90,0.411,28,61,0.459,9,29,0.31,11,14,0.786,42,81,0.519,34,62,0.548,8,19,0.421,17,21,0.81
2/4/2018,9,NYK,ATL,L ,96,99,240,41,94,0.436,36,71,0.507,5,23,0.217,9,15,0.6,35,87,0.402,20,54,0.37,15,33,0.455,14,19,0.737
2/4/2018,14,OKC,LAL,L ,104,108,240,40,89,0.449,33,64,0.516,7,25,0.28,17,25,0.68,42,86,0.488,29,56,0.518,13,30,0.433,11,18,0.611
2/4/2018,9,PHO,CHO,L ,110,115,240,41,77,0.532,26,48,0.542,15,29,0.517,13,13,1,40,96,0.417,30,58,0.517,10,38,0.263,25,29,0.862
2/4/2018,12,TOR,MEM,W ,101,86,240,41,89,0.461,35,54,0.648,6,35,0.171,13,15,0.867,29,81,0.358,21,56,0.375,8,25,0.32,20,23,0.87
2/3/2018,0,CLE,HOU,L ,88,120,240,34,87,0.391,26,57,0.456,8,30,0.267,12,16,0.75,44,93,0.473,25,42,0.595,19,51,0.373,13,16,0.813
2/3/2018,12,DEN,GSW,W ,115,108,240,39,91,0.429,27,62,0.435,12,29,0.414,25,29,0.862,43,86,0.5,35,55,0.636,8,31,0.258,14,23,0.609
2/3/2018,8,DET,MIA,W ,111,107,240,44,84,0.524,35,58,0.603,9,26,0.346,14,17,0.824,44,91,0.484,30,55,0.545,14,36,0.389,5,7,0.714
2/3/2018,6,IND,PHI,W ,100,92,240,35,79,0.443,26,52,0.5,9,27,0.333,21,25,0.84,33,87,0.379,23,55,0.418,10,32,0.313,16,24,0.667
2/3/2018,0,LAC,CHI,W ,113,103,240,40,88,0.455,31,63,0.492,9,25,0.36,24,28,0.857,35,97,0.361,23,60,0.383,12,37,0.324,21,21,1
2/3/2018,0,MIN,NOP,W ,118,107,240,48,95,0.505,38,74,0.514,10,21,0.476,12,16,0.75,42,101,0.416,34,68,0.5,8,33,0.242,15,17,0.882
2/3/2018,8,ORL,WAS,L ,98,115,240,34,77,0.442,24,45,0.533,10,32,0.313,20,22,0.909,46,85,0.541,39,59,0.661,7,26,0.269,16,18,0.889
2/3/2018,11,SAC,DAL,L ,99,106,240,43,82,0.524,35,55,0.636,8,27,0.296,5,6,0.833,41,83,0.494,28,42,0.667,13,41,0.317,11,14,0.786
2/3/2018,1,SAS,UTA,L ,111,120,240,44,91,0.484,34,65,0.523,10,26,0.385,13,18,0.722,39,69,0.565,27,46,0.587,12,23,0.522,30,36,0.833
2/2/2018,4,BOS,ATL,W ,119,110,240,45,89,0.506,34,65,0.523,11,24,0.458,18,20,0.9,34,80,0.425,23,49,0.469,11,31,0.355,31,34,0.912
2/2/2018,17,BRK,LAL,L ,99,102,240,37,82,0.451,28,53,0.528,9,29,0.31,16,23,0.696,39,92,0.424,29,66,0.439,10,26,0.385,14,20,0.7
2/2/2018,1,CHO,IND,W ,133,126,240,44,83,0.53,29,50,0.58,15,33,0.455,30,34,0.882,44,87,0.506,32,58,0.552,12,29,0.414,26,28,0.929
2/2/2018,22,MIL,NYK,W ,92,90,240,33,76,0.434,26,52,0.5,7,24,0.292,19,26,0.731,36,89,0.404,31,64,0.484,5,25,0.2,13,17,0.765
2/2/2018,2,OKC,NOP,L ,100,114,240,37,97,0.381,28,61,0.459,9,36,0.25,17,20,0.85,46,90,0.511,33,66,0.5,13,24,0.542,9,13,0.692
2/2/2018,8,PHI,MIA,W ,103,97,240,42,85,0.494,34,61,0.557,8,24,0.333,11,15,0.733,34,87,0.391,22,50,0.44,12,37,0.324,17,26,0.654
2/2/2018,3,PHO,UTA,L ,97,129,240,36,87,0.414,27,54,0.5,9,33,0.273,16,19,0.842,51,90,0.567,36,61,0.59,15,29,0.517,12,17,0.706
2/2/2018,6,SAC,GSW,L ,104,119,240,42,95,0.442,32,70,0.457,10,25,0.4,10,15,0.667,44,80,0.55,27,47,0.574,17,33,0.515,14,16,0.875
2/2/2018,5,TOR,POR,W ,130,105,240,46,99,0.465,27,59,0.458,19,40,0.475,19,21,0.905,37,73,0.507,30,52,0.577,7,21,0.333,24,33,0.727
2/1/2018,0,DEN,OKC,W ,127,124,240,50,97,0.515,35,59,0.593,15,38,0.395,12,17,0.706,51,98,0.52,42,70,0.6,9,28,0.321,13,17,0.765
2/1/2018,21,DET,MEM,W ,104,102,240,35,76,0.461,28,51,0.549,7,25,0.28,27,37,0.73,40,96,0.417,32,65,0.492,8,31,0.258,14,14,1
2/1/2018,0,MIN,MIL,W ,108,89,240,42,78,0.538,35,59,0.593,7,19,0.368,17,20,0.85,32,85,0.376,26,56,0.464,6,29,0.207,19,25,0.76
2/1/2018,1,SAS,HOU,L ,91,102,240,35,83,0.422,29,59,0.492,6,24,0.25,15,17,0.882,37,83,0.446,23,41,0.561,14,42,0.333,14,17,0.824
2/1/2018,7,WAS,TOR,W ,122,119,240,44,85,0.518,34,55,0.618,10,30,0.333,24,26,0.923,44,83,0.53,32,54,0.593,12,29,0.414,19,24,0.792
1/31/2018,0,ATL,CHO,L ,110,123,240,39,77,0.506,27,45,0.6,12,32,0.375,20,22,0.909,46,90,0.511,29,58,0.5,17,32,0.531,14,18,0.778
1/31/2018,5,BOS,NYK,W ,103,73,240,40,83,0.482,29,57,0.509,11,26,0.423,12,20,0.6,28,87,0.322,25,70,0.357,3,17,0.176,14,21,0.667
1/31/2018,21,BRK,PHI,W ,116,108,240,39,77,0.506,26,45,0.578,13,32,0.406,25,28,0.893,36,76,0.474,29,58,0.5,7,18,0.389,29,34,0.853
1/31/2018,12,CLE,MIA,W ,91,89,240,28,80,0.35,22,54,0.407,6,26,0.231,29,38,0.763,36,83,0.434,33,55,0.6,3,28,0.107,14,25,0.56
1/31/2018,13,IND,MEM,W ,105,101,240,37,70,0.529,27,44,0.614,10,26,0.385,21,31,0.677,39,82,0.476,27,56,0.482,12,26,0.462,11,15,0.733
1/31/2018,1,ORL,LAL,W ,127,105,240,44,81,0.543,26,49,0.531,18,32,0.563,21,29,0.724,39,83,0.47,35,63,0.556,4,20,0.2,23,30,0.767
1/31/2018,0,PHO,DAL,W ,102,88,240,40,83,0.482,29,53,0.547,11,30,0.367,11,15,0.733,32,88,0.364,22,52,0.423,10,36,0.278,14,26,0.538
1/31/2018,0,POR,CHI,W ,124,108,240,46,82,0.561,31,50,0.62,15,32,0.469,17,20,0.85,41,99,0.414,28,65,0.431,13,34,0.382,13,22,0.591
1/30/2018,8,DET,CLE,W ,125,114,240,49,93,0.527,40,70,0.571,9,23,0.391,18,28,0.643,38,84,0.452,25,49,0.51,13,35,0.371,25,32,0.781
1/30/2018,12,HOU,ORL,W ,114,107,240,39,77,0.506,26,42,0.619,13,35,0.371,23,28,0.821,42,83,0.506,27,52,0.519,15,31,0.484,8,10,0.8
1/30/2018,8,LAC,POR,L ,96,104,240,35,85,0.412,29,63,0.46,6,22,0.273,20,26,0.769,36,98,0.367,23,68,0.338,13,30,0.433,19,22,0.864
1/30/2018,15,NOP,SAC,L ,103,114,240,39,77,0.506,30,52,0.577,9,25,0.36,16,22,0.727,46,97,0.474,36,71,0.507,10,26,0.385,12,14,0.857
1/30/2018,1,NYK,BRK,W ,111,95,240,39,89,0.438,26,63,0.413,13,26,0.5,20,25,0.8,36,87,0.414,27,50,0.54,9,37,0.243,14,16,0.875
1/30/2018,18,SAS,DEN,W ,106,104,240,46,92,0.5,37,68,0.544,9,24,0.375,5,5,1,40,86,0.465,30,63,0.476,10,23,0.435,14,14,1
1/30/2018,5,TOR,MIN,W ,109,104,240,39,81,0.481,30,52,0.577,9,29,0.31,22,26,0.846,42,85,0.494,37,73,0.507,5,12,0.417,15,24,0.625
1/30/2018,2,UTA,GSW,W ,129,99,240,53,91,0.582,39,63,0.619,14,28,0.5,9,14,0.643,39,85,0.459,34,60,0.567,5,25,0.2,16,21,0.762
1/30/2018,16,WAS,OKC,W ,102,96,240,34,89,0.382,27,64,0.422,7,25,0.28,27,29,0.931,30,80,0.375,21,48,0.438,9,32,0.281,27,34,0.794
1/29/2018,9,ATL,MIN,W ,105,100,240,39,79,0.494,26,45,0.578,13,34,0.382,14,16,0.875,39,83,0.47,32,64,0.5,7,19,0.368,15,18,0.833
1/29/2018,5,DAL,MIA,L ,88,95,240,33,86,0.384,25,57,0.439,8,29,0.276,14,16,0.875,34,75,0.453,22,44,0.5,12,31,0.387,15,19,0.789
1/29/2018,11,DEN,BOS,L ,110,111,240,42,93,0.452,32,60,0.533,10,33,0.303,16,21,0.762,43,91,0.473,26,55,0.473,17,36,0.472,8,10,0.8
1/29/2018,18,IND,CHO,W ,105,96,240,45,83,0.542,39,62,0.629,6,21,0.286,9,11,0.818,37,83,0.446,28,52,0.538,9,31,0.29,13,20,0.65
1/29/2018,1,MEM,PHO,W ,120,109,240,47,83,0.566,36,61,0.59,11,22,0.5,15,18,0.833,38,82,0.463,31,59,0.525,7,23,0.304,26,36,0.722
1/29/2018,4,MIL,PHI,W ,107,95,240,38,80,0.475,27,52,0.519,11,28,0.393,20,22,0.909,36,82,0.439,34,56,0.607,2,26,0.077,21,23,0.913
1/28/2018,1,CHI,MIL,L ,96,110,240,36,87,0.414,24,53,0.453,12,34,0.353,12,15,0.8,41,77,0.532,28,49,0.571,13,28,0.464,15,25,0.6
1/28/2018,15,CLE,DET,W ,121,104,240,42,83,0.506,27,48,0.563,15,35,0.429,22,26,0.846,40,95,0.421,26,59,0.441,14,36,0.389,10,13,0.769
1/28/2018,5,HOU,PHO,W ,113,102,240,32,72,0.444,21,35,0.6,11,37,0.297,38,49,0.776,36,85,0.424,28,52,0.538,8,33,0.242,22,26,0.846
1/28/2018,3,NOP,LAC,L ,103,112,240,38,85,0.447,29,50,0.58,9,35,0.257,18,25,0.72,45,96,0.469,36,68,0.529,9,28,0.321,13,18,0.722
1/28/2018,9,OKC,PHI,W ,122,112,240,45,92,0.489,35,59,0.593,10,33,0.303,22,30,0.733,38,76,0.5,27,47,0.574,11,29,0.379,25,31,0.806
1/28/2018,10,SAS,SAC,W ,113,98,240,45,90,0.5,34,65,0.523,11,25,0.44,12,17,0.706,35,82,0.427,17,48,0.354,18,34,0.529,10,11,0.909
1/28/2018,1,TOR,LAL,W ,123,111,240,46,92,0.5,34,61,0.557,12,31,0.387,19,25,0.76,40,91,0.44,32,66,0.485,8,25,0.32,23,33,0.697
1/27/2018,0,ATL,WAS,L ,104,129,240,38,88,0.432,26,45,0.578,12,43,0.279,16,21,0.762,49,85,0.576,31,53,0.585,18,32,0.563,13,14,0.929
1/27/2018,6,DEN,DAL,W ,91,89,240,34,81,0.42,22,48,0.458,12,33,0.364,11,15,0.733,34,85,0.4,23,54,0.426,11,31,0.355,10,19,0.526
1/27/2018,6,DET,OKC,L ,108,121,240,39,84,0.464,27,51,0.529,12,33,0.364,18,24,0.75,45,93,0.484,31,60,0.517,14,33,0.424,17,23,0.739
1/27/2018,7,GSW,BOS,W ,109,105,240,38,84,0.452,28,57,0.491,10,27,0.37,23,26,0.885,37,85,0.435,23,57,0.404,14,28,0.5,17,24,0.708
1/27/2018,1,IND,ORL,W ,114,112,240,47,87,0.54,42,69,0.609,5,18,0.278,15,19,0.789,42,77,0.545,34,52,0.654,8,25,0.32,20,32,0.625
1/27/2018,4,MIA,CHO,W ,95,91,240,38,85,0.447,30,59,0.508,8,26,0.308,11,18,0.611,29,84,0.345,24,60,0.4,5,24,0.208,28,35,0.8
1/27/2018,3,MIN,BRK,W ,111,97,240,42,96,0.438,38,75,0.507,4,21,0.19,23,26,0.885,38,82,0.463,29,52,0.558,9,30,0.3,12,15,0.8
1/26/2018,5,CHI,LAL,L ,103,108,240,35,93,0.376,18,57,0.316,17,36,0.472,16,24,0.667,41,91,0.451,36,67,0.537,5,24,0.208,21,28,0.75
1/26/2018,12,CHO,ATL,W ,121,110,240,40,88,0.455,27,54,0.5,13,34,0.382,28,32,0.875,37,79,0.468,22,49,0.449,15,30,0.5,21,25,0.84
1/26/2018,0,CLE,IND,W ,115,108,240,46,82,0.561,33,45,0.733,13,37,0.351,10,13,0.769,43,91,0.473,30,60,0.5,13,31,0.419,9,11,0.818
1/26/2018,5,DAL,POR,L ,93,107,240,35,89,0.393,25,59,0.424,10,30,0.333,13,17,0.765,39,79,0.494,29,49,0.592,10,30,0.333,19,23,0.826
1/26/2018,5,MEM,LAC,L ,100,109,240,39,81,0.481,31,54,0.574,8,27,0.296,14,18,0.778,39,80,0.488,29,53,0.547,10,27,0.37,21,29,0.724
1/26/2018,0,MIL,BRK,W ,116,91,240,43,83,0.518,31,60,0.517,12,23,0.522,18,20,0.9,33,89,0.371,25,55,0.455,8,34,0.235,17,20,0.85
1/26/2018,8,NOP,HOU,W ,115,113,240,44,82,0.537,33,55,0.6,11,27,0.407,16,21,0.762,36,78,0.462,24,42,0.571,12,36,0.333,29,35,0.829
1/26/2018,0,PHO,NYK,L ,85,107,240,33,94,0.351,22,61,0.361,11,33,0.333,8,13,0.615,41,85,0.482,32,60,0.533,9,25,0.36,16,22,0.727
1/26/2018,2,SAS,PHI,L ,78,97,240,30,75,0.4,27,51,0.529,3,24,0.125,15,18,0.833,38,79,0.481,29,58,0.5,9,21,0.429,12,18,0.667
1/26/2018,14,TOR,UTA,L ,93,97,240,37,95,0.389,30,68,0.441,7,27,0.259,12,17,0.706,36,87,0.414,26,66,0.394,10,21,0.476,15,21,0.714
1/25/2018,2,DEN,NYK,W ,130,118,240,48,80,0.6,34,52,0.654,14,28,0.5,20,24,0.833,45,82,0.549,37,61,0.607,8,21,0.381,20,24,0.833
1/25/2018,0,GSW,MIN,W ,126,113,240,48,89,0.539,27,52,0.519,21,37,0.568,9,15,0.6,46,101,0.455,40,81,0.494,6,20,0.3,15,18,0.833
1/25/2018,19,MIA,SAC,L ,88,89,240,31,82,0.378,19,48,0.396,12,34,0.353,14,18,0.778,38,81,0.469,33,69,0.478,5,12,0.417,8,14,0.571
1/25/2018,0,OKC,WAS,W ,121,112,240,45,87,0.517,36,60,0.6,9,27,0.333,22,29,0.759,42,86,0.488,26,51,0.51,16,35,0.457,12,16,0.75
1/24/2018,0,ATL,TOR,L ,93,108,240,37,94,0.394,30,73,0.411,7,21,0.333,12,17,0.706,39,89,0.438,25,53,0.472,14,36,0.389,16,25,0.64
1/24/2018,10,CHO,NOP,L ,96,101,240,36,85,0.424,30,64,0.469,6,21,0.286,18,31,0.581,39,87,0.448,30,61,0.492,9,26,0.346,14,18,0.778
1/24/2018,1,DAL,HOU,L ,97,104,240,35,82,0.427,20,47,0.426,15,35,0.429,12,18,0.667,36,82,0.439,15,31,0.484,21,51,0.412,11,23,0.478
1/24/2018,19,DET,UTA,L ,95,98,265,38,97,0.392,31,66,0.47,7,31,0.226,12,18,0.667,38,96,0.396,28,65,0.431,10,31,0.323,12,16,0.75
1/24/2018,0,IND,PHO,W ,116,101,240,45,80,0.563,36,56,0.643,9,24,0.375,17,25,0.68,35,84,0.417,26,49,0.531,9,35,0.257,22,29,0.759
1/24/2018,9,LAC,BOS,L ,102,113,240,35,79,0.443,30,58,0.517,5,21,0.238,27,39,0.692,39,93,0.419,25,53,0.472,14,40,0.35,21,22,0.955
1/24/2018,1,MEM,SAS,L ,85,108,240,36,83,0.434,34,65,0.523,2,18,0.111,11,14,0.786,38,82,0.463,28,58,0.483,10,24,0.417,22,25,0.88
1/24/2018,0,PHI,CHI,W ,115,101,240,42,81,0.519,26,49,0.531,16,32,0.5,15,20,0.75,36,94,0.383,25,57,0.439,11,37,0.297,18,22,0.818
1/24/2018,6,POR,MIN,W ,123,114,240,45,82,0.549,28,51,0.549,17,31,0.548,16,21,0.762,45,84,0.536,39,68,0.574,6,16,0.375,18,22,0.818
1/23/2018,1,GSW,NYK,W ,123,112,240,46,83,0.554,33,53,0.623,13,30,0.433,18,20,0.9,43,83,0.518,34,61,0.557,9,22,0.409,17,19,0.895
1/23/2018,18,LAL,BOS,W ,108,107,240,40,91,0.44,33,65,0.508,7,26,0.269,21,36,0.583,42,90,0.467,27,46,0.587,15,44,0.341,8,10,0.8
1/23/2018,20,OKC,BRK,W ,109,108,240,40,94,0.426,33,69,0.478,7,25,0.28,22,32,0.688,37,79,0.468,21,41,0.512,16,38,0.421,18,25,0.72
1/23/2018,12,ORL,SAC,L ,99,105,240,36,83,0.434,25,52,0.481,11,31,0.355,16,19,0.842,43,87,0.494,35,61,0.574,8,26,0.308,11,13,0.846
1/23/2018,9,SAS,CLE,W ,114,102,240,47,94,0.5,39,66,0.591,8,28,0.286,12,16,0.75,35,72,0.486,29,51,0.569,6,21,0.286,26,31,0.839
1/22/2018,8,ATL,UTA,W ,104,90,240,40,83,0.482,28,57,0.491,12,26,0.462,12,12,1,33,76,0.434,29,61,0.475,4,15,0.267,20,28,0.714
1/22/2018,15,CHO,SAC,W ,112,107,240,38,86,0.442,22,46,0.478,16,40,0.4,20,25,0.8,43,97,0.443,33,75,0.44,10,22,0.455,11,15,0.733
1/22/2018,5,DAL,WAS,W ,98,75,240,38,87,0.437,28,56,0.5,10,31,0.323,12,17,0.706,26,86,0.302,19,54,0.352,7,32,0.219,16,27,0.593
1/22/2018,18,DEN,POR,W ,104,101,240,34,83,0.41,24,53,0.453,10,30,0.333,26,33,0.788,36,85,0.424,28,60,0.467,8,25,0.32,21,26,0.808
1/22/2018,15,HOU,MIA,W ,99,90,240,36,81,0.444,21,44,0.477,15,37,0.405,12,18,0.667,39,82,0.476,32,52,0.615,7,30,0.233,5,9,0.556
1/22/2018,22,LAC,MIN,L ,118,126,240,47,84,0.56,38,57,0.667,9,27,0.333,15,22,0.682,43,91,0.473,36,69,0.522,7,22,0.318,33,39,0.846
1/22/2018,3,MEM,PHI,W ,105,101,240,33,78,0.423,23,52,0.442,10,26,0.385,29,35,0.829,32,71,0.451,18,40,0.45,14,31,0.452,23,31,0.742
1/22/2018,15,MIL,PHO,W ,109,105,240,38,71,0.535,33,54,0.611,5,17,0.294,28,37,0.757,39,79,0.494,30,53,0.566,9,26,0.346,18,20,0.9
1/22/2018,11,NOP,CHI,W ,132,128,290,47,113,0.416,31,69,0.449,16,44,0.364,22,26,0.846,45,92,0.489,37,61,0.607,8,31,0.258,30,34,0.882
1/21/2018,12,BOS,ORL,L ,95,103,240,37,85,0.435,29,58,0.5,8,27,0.296,13,14,0.929,43,92,0.467,37,71,0.521,6,21,0.286,11,16,0.688
1/21/2018,5,DET,BRK,L ,100,101,240,38,90,0.422,29,61,0.475,9,29,0.31,15,17,0.882,37,80,0.463,24,49,0.49,13,31,0.419,14,20,0.7
1/21/2018,12,LAL,NYK,W ,127,107,240,51,91,0.56,41,65,0.631,10,26,0.385,15,21,0.714,44,81,0.543,32,56,0.571,12,25,0.48,7,10,0.7
1/21/2018,10,SAS,IND,L ,86,94,240,35,82,0.427,26,48,0.542,9,34,0.265,7,12,0.583,37,84,0.44,33,65,0.508,4,19,0.211,16,17,0.941
1/20/2018,0,ATL,CHI,L ,97,113,240,35,92,0.38,24,44,0.545,11,48,0.229,16,23,0.696,40,80,0.5,26,48,0.542,14,32,0.438,19,21,0.905
1/20/2018,3,CHO,MIA,L ,105,106,240,41,90,0.456,34,63,0.54,7,27,0.259,16,21,0.762,43,87,0.494,30,59,0.508,13,28,0.464,7,12,0.583
1/20/2018,0,CLE,OKC,L ,124,148,240,46,89,0.517,36,52,0.692,10,37,0.27,22,27,0.815,58,100,0.58,44,70,0.629,14,30,0.467,18,28,0.643
1/20/2018,7,HOU,GSW,W ,116,108,240,41,87,0.471,27,50,0.54,14,37,0.378,20,29,0.69,40,82,0.488,23,46,0.5,17,36,0.472,11,15,0.733
1/20/2018,11,MIN,TOR,W ,115,109,240,38,81,0.469,31,65,0.477,7,16,0.438,32,42,0.762,39,83,0.47,27,50,0.54,12,33,0.364,19,21,0.905
1/20/2018,0,NOP,MEM,W ,111,104,240,39,78,0.5,32,51,0.627,7,27,0.259,26,32,0.813,37,82,0.451,22,47,0.468,15,35,0.429,15,16,0.938
1/20/2018,2,PHI,MIL,W ,116,94,240,45,85,0.529,35,60,0.583,10,25,0.4,16,19,0.842,33,82,0.402,23,50,0.46,10,32,0.313,18,22,0.818
1/20/2018,2,POR,DAL,W ,117,108,240,45,86,0.523,27,50,0.54,18,36,0.5,9,10,0.9,38,83,0.458,28,58,0.483,10,25,0.4,22,28,0.786
1/20/2018,0,UTA,LAC,W ,125,113,240,45,82,0.549,34,54,0.63,11,28,0.393,24,32,0.75,36,82,0.439,25,46,0.543,11,36,0.306,30,38,0.789
1/19/2018,7,BRK,MIA,W ,101,95,240,36,76,0.474,27,44,0.614,9,32,0.281,20,26,0.769,35,84,0.417,28,62,0.452,7,22,0.318,18,25,0.72
1/19/2018,1,DEN,PHO,L ,100,108,240,35,78,0.449,21,42,0.5,14,36,0.389,16,21,0.762,40,81,0.494,26,48,0.542,14,33,0.424,14,20,0.7
1/19/2018,6,DET,WAS,L ,112,122,240,40,80,0.5,30,50,0.6,10,30,0.333,22,26,0.846,41,82,0.5,25,47,0.532,16,35,0.457,24,27,0.889
1/19/2018,5,LAL,IND,W ,99,86,240,44,80,0.55,35,52,0.673,9,28,0.321,2,14,0.143,37,97,0.381,35,72,0.486,2,25,0.08,10,13,0.769
1/19/2018,2,MEM,SAC,W ,106,88,240,39,88,0.443,29,54,0.537,10,34,0.294,18,23,0.783,32,80,0.4,21,53,0.396,11,27,0.407,13,18,0.722
1/19/2018,8,TOR,SAS,W ,86,83,240,34,85,0.4,25,59,0.424,9,26,0.346,9,14,0.643,31,91,0.341,26,71,0.366,5,20,0.25,16,20,0.8
1/19/2018,16,UTA,NYK,L ,115,117,240,42,91,0.462,31,60,0.517,11,31,0.355,20,30,0.667,44,89,0.494,33,69,0.478,11,20,0.55,18,23,0.783
1/18/2018,5,BOS,PHI,L ,80,89,240,30,74,0.405,23,45,0.511,7,29,0.241,13,17,0.765,34,73,0.466,28,56,0.5,6,17,0.353,15,17,0.882
1/18/2018,2,CLE,ORL,W ,104,103,240,38,85,0.447,28,51,0.549,10,34,0.294,18,27,0.667,41,88,0.466,36,66,0.545,5,22,0.227,16,21,0.762
1/18/2018,5,HOU,MIN,W ,116,98,240,42,88,0.477,25,49,0.51,17,39,0.436,15,17,0.882,38,81,0.469,30,57,0.526,8,24,0.333,14,21,0.667
1/18/2018,13,POR,IND,W ,100,86,240,37,94,0.394,27,62,0.435,10,32,0.313,16,16,1,36,91,0.396,29,65,0.446,7,26,0.269,7,13,0.538
1/17/2018,4,ATL,NOP,W ,94,93,240,37,89,0.416,27,49,0.551,10,40,0.25,10,13,0.769,35,80,0.438,25,53,0.472,10,27,0.37,13,19,0.684
1/17/2018,10,BRK,SAS,L ,95,100,240,35,83,0.422,22,47,0.468,13,36,0.361,12,18,0.667,34,82,0.415,25,63,0.397,9,19,0.474,23,31,0.742
1/17/2018,7,CHI,GSW,L ,112,119,240,45,106,0.425,35,67,0.522,10,39,0.256,12,13,0.923,42,84,0.5,29,51,0.569,13,33,0.394,22,25,0.88
1/17/2018,2,CHO,WAS,W ,133,109,240,48,98,0.49,33,67,0.493,15,31,0.484,22,26,0.846,40,82,0.488,27,59,0.458,13,23,0.565,16,23,0.696
1/17/2018,15,LAC,DEN,W ,109,104,240,40,87,0.46,30,57,0.526,10,30,0.333,19,31,0.613,42,97,0.433,37,72,0.514,5,25,0.2,15,18,0.833
1/17/2018,5,MEM,NYK,W ,105,99,240,41,91,0.451,31,63,0.492,10,28,0.357,13,17,0.765,35,82,0.427,28,55,0.509,7,27,0.259,22,23,0.957
1/17/2018,19,MIL,MIA,L ,101,106,240,33,76,0.434,22,48,0.458,11,28,0.393,24,32,0.75,38,82,0.463,28,58,0.483,10,24,0.417,20,27,0.741
1/17/2018,6,OKC,LAL,W ,114,90,240,46,95,0.484,34,60,0.567,12,35,0.343,10,12,0.833,38,81,0.469,28,55,0.509,10,26,0.385,4,4,1
1/17/2018,3,SAC,UTA,L ,105,120,240,38,72,0.528,25,51,0.49,13,21,0.619,16,20,0.8,46,81,0.568,34,52,0.654,12,29,0.414,16,20,0.8
1/17/2018,8,TOR,DET,W ,96,91,240,34,80,0.425,23,49,0.469,11,31,0.355,17,23,0.739,37,88,0.42,27,60,0.45,10,28,0.357,7,15,0.467
1/16/2018,18,BOS,NOP,L ,113,116,265,40,101,0.396,21,51,0.412,19,50,0.38,14,16,0.875,45,100,0.45,38,73,0.521,7,27,0.259,19,25,0.76
1/16/2018,1,DEN,DAL,W ,105,102,240,40,86,0.465,32,60,0.533,8,26,0.308,17,26,0.654,38,78,0.487,30,51,0.588,8,27,0.296,18,22,0.818
1/16/2018,13,ORL,MIN,W ,108,102,240,40,90,0.444,29,59,0.492,11,31,0.355,17,19,0.895,43,98,0.439,36,82,0.439,7,16,0.438,9,10,0.9
1/16/2018,4,POR,PHO,W ,118,111,240,46,91,0.505,29,56,0.518,17,35,0.486,9,10,0.9,37,89,0.416,21,48,0.438,16,41,0.39,21,22,0.955
1/15/2018,7,ATL,SAS,W ,102,99,240,40,86,0.465,31,61,0.508,9,25,0.36,13,14,0.929,37,87,0.425,29,65,0.446,8,22,0.364,17,20,0.85
1/15/2018,6,BRK,NYK,L ,104,119,240,32,87,0.368,21,55,0.382,11,32,0.344,29,36,0.806,42,82,0.512,33,66,0.5,9,16,0.563,26,37,0.703
1/15/2018,2,CHI,MIA,W ,119,111,240,42,88,0.477,26,49,0.531,16,39,0.41,19,22,0.864,40,84,0.476,28,48,0.583,12,36,0.333,19,24,0.792
1/15/2018,15,CLE,GSW,L ,108,118,240,43,94,0.457,36,66,0.545,7,28,0.25,15,22,0.682,41,85,0.482,29,53,0.547,12,32,0.375,24,30,0.8
1/15/2018,11,DET,CHO,L ,107,118,240,42,86,0.488,27,57,0.474,15,29,0.517,8,11,0.727,43,84,0.512,33,63,0.524,10,21,0.476,22,33,0.667
1/15/2018,3,LAC,HOU,W ,113,102,240,44,79,0.557,34,54,0.63,10,25,0.4,15,20,0.75,38,94,0.404,25,50,0.5,13,44,0.295,13,16,0.813
1/15/2018,1,MEM,LAL,W ,123,114,240,42,82,0.512,32,60,0.533,10,22,0.455,29,34,0.853,38,96,0.396,26,61,0.426,12,35,0.343,26,31,0.839
1/15/2018,13,OKC,SAC,W ,95,88,240,36,86,0.419,27,56,0.482,9,30,0.3,14,29,0.483,33,84,0.393,26,54,0.481,7,30,0.233,15,25,0.6
1/15/2018,0,PHI,TOR,W ,117,111,240,40,81,0.494,34,56,0.607,6,25,0.24,31,38,0.816,38,95,0.4,29,63,0.46,9,32,0.281,26,30,0.867
1/15/2018,4,UTA,IND,L ,94,109,240,36,81,0.444,27,48,0.563,9,33,0.273,13,17,0.765,41,77,0.532,27,51,0.529,14,26,0.538,13,15,0.867
1/15/2018,13,WAS,MIL,L ,95,104,240,32,76,0.421,26,55,0.473,6,21,0.286,25,31,0.806,38,81,0.469,30,65,0.462,8,16,0.5,20,29,0.69
1/14/2018,9,MIA,MIL,W ,97,79,240,35,76,0.461,24,47,0.511,11,29,0.379,16,20,0.8,25,79,0.316,21,51,0.412,4,28,0.143,25,27,0.926
1/14/2018,10,MIN,POR,W ,120,103,240,43,80,0.538,36,61,0.59,7,19,0.368,27,33,0.818,39,79,0.494,28,54,0.519,11,25,0.44,14,17,0.824
1/14/2018,5,NYK,NOP,L ,118,123,265,46,97,0.474,34,63,0.54,12,34,0.353,14,18,0.778,45,95,0.474,36,63,0.571,9,32,0.281,24,34,0.706
1/14/2018,2,PHO,IND,L ,97,120,240,35,85,0.412,26,48,0.542,9,37,0.243,18,24,0.75,48,88,0.545,37,65,0.569,11,23,0.478,13,14,0.929
1/13/2018,23,CHI,DET,W ,107,105,240,42,87,0.483,25,51,0.49,17,36,0.472,6,9,0.667,41,92,0.446,29,63,0.46,12,29,0.414,11,14,0.786
1/13/2018,12,CHO,OKC,L ,91,101,240,33,83,0.398,24,55,0.436,9,28,0.321,16,23,0.696,39,97,0.402,31,71,0.437,8,26,0.308,15,20,0.75
1/13/2018,12,DAL,LAL,L ,101,107,265,34,90,0.378,23,47,0.489,11,43,0.256,22,28,0.786,43,95,0.453,35,69,0.507,8,26,0.308,13,18,0.722
1/13/2018,1,LAC,SAC,W ,126,105,240,46,82,0.561,34,51,0.667,12,31,0.387,22,26,0.846,43,85,0.506,37,68,0.544,6,17,0.353,13,22,0.591
1/13/2018,0,SAS,DEN,W ,112,80,240,41,79,0.519,27,52,0.519,14,27,0.519,16,18,0.889,29,83,0.349,22,55,0.4,7,28,0.25,15,17,0.882
1/13/2018,3,TOR,GSW,L ,125,127,240,45,93,0.484,37,68,0.544,8,25,0.32,27,32,0.844,47,81,0.58,38,57,0.667,9,24,0.375,24,28,0.857
1/13/2018,0,WAS,BRK,W ,119,113,265,46,93,0.495,36,70,0.514,10,23,0.435,17,23,0.739,42,99,0.424,30,56,0.536,12,43,0.279,17,20,0.85
1/12/2018,12,ATL,BRK,L ,105,110,240,37,80,0.463,26,52,0.5,11,28,0.393,20,26,0.769,40,87,0.46,27,53,0.509,13,34,0.382,17,26,0.654
1/12/2018,10,CHO,UTA,W ,99,88,240,32,78,0.41,23,51,0.451,9,27,0.333,26,34,0.765,28,77,0.364,16,42,0.381,12,35,0.343,20,23,0.87
1/12/2018,3,DEN,MEM,W ,87,78,240,27,70,0.386,20,48,0.417,7,22,0.318,26,32,0.813,30,77,0.39,23,53,0.434,7,24,0.292,11,14,0.786
1/12/2018,8,IND,CLE,W ,97,95,240,39,85,0.459,29,64,0.453,10,21,0.476,9,12,0.75,37,85,0.435,30,51,0.588,7,34,0.206,14,19,0.737
1/12/2018,3,MIL,GSW,L ,94,108,240,36,85,0.424,25,57,0.439,11,28,0.393,11,12,0.917,44,79,0.557,39,64,0.609,5,15,0.333,15,18,0.833
1/12/2018,6,MIN,NYK,W ,118,108,240,49,95,0.516,39,68,0.574,10,27,0.37,10,16,0.625,45,83,0.542,33,59,0.559,12,24,0.5,6,9,0.667
1/12/2018,4,NOP,POR,W ,119,113,240,45,82,0.549,38,63,0.603,7,19,0.368,22,23,0.957,45,101,0.446,33,59,0.559,12,42,0.286,11,14,0.786
1/12/2018,4,PHO,HOU,L ,95,112,240,37,80,0.463,23,47,0.489,14,33,0.424,7,9,0.778,39,94,0.415,24,47,0.511,15,47,0.319,19,22,0.864
1/12/2018,12,WAS,ORL,W ,125,119,240,54,95,0.568,50,79,0.633,4,16,0.25,13,19,0.684,41,80,0.513,29,51,0.569,12,29,0.414,25,31,0.806
1/11/2018,4,LAL,SAS,W ,93,81,240,36,87,0.414,23,49,0.469,13,38,0.342,8,14,0.571,31,76,0.408,23,56,0.411,8,20,0.4,11,15,0.733
1/11/2018,1,PHI,BOS,L ,103,114,240,38,82,0.463,27,54,0.5,11,28,0.393,16,18,0.889,43,89,0.483,30,54,0.556,13,35,0.371,15,19,0.789
1/11/2018,6,SAC,LAC,L ,115,121,240,42,85,0.494,34,59,0.576,8,26,0.308,23,28,0.821,43,84,0.512,30,53,0.566,13,31,0.419,22,30,0.733
1/11/2018,0,TOR,CLE,W ,133,99,240,53,106,0.5,35,64,0.547,18,42,0.429,9,13,0.692,34,89,0.382,28,63,0.444,6,26,0.231,25,30,0.833
1/10/2018,5,BRK,DET,L ,80,114,240,27,74,0.365,15,37,0.405,12,37,0.324,14,15,0.933,48,93,0.516,38,72,0.528,10,21,0.476,8,12,0.667
1/10/2018,3,CHO,DAL,L ,111,115,240,43,84,0.512,33,58,0.569,10,26,0.385,15,30,0.5,39,83,0.47,24,47,0.511,15,36,0.417,22,28,0.786
1/10/2018,1,DEN,ATL,L ,97,110,240,38,95,0.4,29,58,0.5,9,37,0.243,12,20,0.6,40,80,0.5,28,53,0.528,12,27,0.444,18,18,1
1/10/2018,18,GSW,LAC,L ,106,125,240,38,79,0.481,30,56,0.536,8,23,0.348,22,26,0.846,46,94,0.489,35,70,0.5,11,24,0.458,22,28,0.786
1/10/2018,4,HOU,POR,W ,121,112,240,45,100,0.45,33,62,0.532,12,38,0.316,19,25,0.76,40,83,0.482,31,57,0.544,9,26,0.346,23,32,0.719
1/10/2018,1,IND,MIA,L ,106,114,240,43,87,0.494,42,69,0.609,1,18,0.056,19,29,0.655,43,81,0.531,30,51,0.588,13,30,0.433,15,21,0.714
1/10/2018,12,MEM,NOP,W ,105,102,240,37,88,0.42,32,69,0.464,5,19,0.263,26,32,0.813,34,77,0.442,23,42,0.548,11,35,0.314,23,34,0.676
1/10/2018,7,MIL,ORL,W ,110,103,240,45,82,0.549,41,63,0.651,4,19,0.211,16,25,0.64,39,90,0.433,31,61,0.508,8,29,0.276,17,18,0.944
1/10/2018,11,MIN,OKC,W ,104,88,240,39,80,0.488,32,60,0.533,7,20,0.35,19,27,0.704,32,80,0.4,26,55,0.473,6,25,0.24,18,24,0.75
1/10/2018,7,NYK,CHI,L ,119,122,290,48,96,0.5,38,74,0.514,10,22,0.455,13,21,0.619,45,98,0.459,30,65,0.462,15,33,0.455,17,20,0.85
1/10/2018,8,WAS,UTA,L ,104,107,240,41,78,0.526,31,53,0.585,10,25,0.4,12,17,0.706,43,92,0.467,32,59,0.542,11,33,0.333,10,13,0.769
1/9/2018,4,DAL,ORL,W ,114,99,240,43,83,0.518,34,57,0.596,9,26,0.346,19,22,0.864,36,79,0.456,25,50,0.5,11,29,0.379,16,22,0.727
1/9/2018,8,LAL,SAC,W ,99,86,240,37,77,0.481,25,42,0.595,12,35,0.343,13,21,0.619,30,87,0.345,22,66,0.333,8,21,0.381,18,27,0.667
1/9/2018,13,OKC,POR,L ,106,117,240,37,84,0.44,24,53,0.453,13,31,0.419,19,26,0.731,43,81,0.531,33,58,0.569,10,23,0.435,21,26,0.808
1/9/2018,14,TOR,MIA,L ,89,90,240,35,90,0.389,28,69,0.406,7,21,0.333,12,15,0.8,39,97,0.402,35,75,0.467,4,22,0.182,8,10,0.8
1/8/2018,10,BRK,TOR,L ,113,114,265,39,100,0.39,27,67,0.403,12,33,0.364,23,28,0.821,43,101,0.426,33,67,0.493,10,34,0.294,18,23,0.783
1/8/2018,5,CHI,HOU,L ,107,116,240,40,86,0.465,28,58,0.483,12,28,0.429,15,18,0.833,39,86,0.453,19,32,0.594,20,54,0.37,18,24,0.75
1/8/2018,6,GSW,DEN,W ,124,114,240,48,85,0.565,35,55,0.636,13,30,0.433,15,21,0.714,47,95,0.495,39,76,0.513,8,19,0.421,12,16,0.75
1/8/2018,3,IND,MIL,W ,109,96,240,44,79,0.557,37,57,0.649,7,22,0.318,14,20,0.7,34,74,0.459,27,47,0.574,7,27,0.259,21,27,0.778
1/8/2018,2,LAC,ATL,W ,108,107,240,38,85,0.447,29,67,0.433,9,18,0.5,23,34,0.676,38,96,0.396,28,59,0.475,10,37,0.27,21,29,0.724
1/8/2018,0,MIN,CLE,W ,127,99,240,52,100,0.52,42,69,0.609,10,31,0.323,13,17,0.765,37,84,0.44,24,46,0.522,13,38,0.342,12,16,0.75
1/8/2018,4,NOP,DET,W ,112,109,240,46,82,0.561,40,60,0.667,6,22,0.273,14,21,0.667,41,93,0.441,33,66,0.5,8,27,0.296,19,22,0.864
1/8/2018,4,SAC,SAS,L ,100,107,240,40,82,0.488,32,59,0.542,8,23,0.348,12,16,0.75,44,90,0.489,33,64,0.516,11,26,0.423,8,13,0.615
1/7/2018,0,DAL,NYK,L ,96,100,240,35,92,0.38,29,68,0.426,6,24,0.25,20,24,0.833,38,83,0.458,32,67,0.478,6,16,0.375,18,20,0.9
1/7/2018,3,LAL,ATL,W ,132,113,240,48,86,0.558,32,50,0.64,16,36,0.444,20,25,0.8,41,94,0.436,29,60,0.483,12,34,0.353,19,23,0.826
1/7/2018,18,MIA,UTA,W ,103,102,240,40,83,0.482,31,54,0.574,9,29,0.31,14,20,0.7,37,82,0.451,27,50,0.54,10,32,0.313,18,20,0.9
1/7/2018,1,PHO,OKC,W ,114,100,240,39,88,0.443,22,49,0.449,17,39,0.436,19,23,0.826,40,86,0.465,32,59,0.542,8,27,0.296,12,21,0.571
1/7/2018,9,POR,SAS,W ,111,110,240,48,92,0.522,40,69,0.58,8,23,0.348,7,10,0.7,40,81,0.494,29,58,0.5,11,23,0.478,19,26,0.731
1/6/2018,9,BRK,BOS,L ,85,87,240,30,91,0.33,24,60,0.4,6,31,0.194,19,22,0.864,37,98,0.378,32,80,0.4,5,18,0.278,8,15,0.533
1/6/2018,13,DET,HOU,W ,108,101,240,38,75,0.507,26,50,0.52,12,25,0.48,20,27,0.741,38,90,0.422,23,43,0.535,15,47,0.319,10,11,0.909
1/6/2018,6,IND,CHI,W ,125,86,240,48,86,0.558,33,55,0.6,15,31,0.484,14,18,0.778,30,80,0.375,20,48,0.417,10,32,0.313,16,20,0.8
1/6/2018,1,LAC,GSW,L ,105,121,240,39,91,0.429,36,80,0.45,3,11,0.273,24,30,0.8,39,94,0.415,26,55,0.473,13,39,0.333,30,37,0.811
1/6/2018,0,MIN,NOP,W ,116,98,240,44,90,0.489,35,72,0.486,9,18,0.5,19,21,0.905,33,78,0.423,27,49,0.551,6,29,0.207,26,28,0.929
1/6/2018,7,ORL,CLE,L ,127,131,240,49,98,0.5,35,61,0.574,14,37,0.378,15,22,0.682,47,94,0.5,32,60,0.533,15,34,0.441,22,31,0.71
1/6/2018,0,SAC,DEN,W ,106,98,240,42,94,0.447,33,69,0.478,9,25,0.36,13,17,0.765,35,76,0.461,22,42,0.524,13,34,0.382,15,21,0.714
1/6/2018,13,WAS,MIL,L ,103,110,240,37,78,0.474,29,57,0.509,8,21,0.381,21,29,0.724,39,80,0.488,32,58,0.552,7,22,0.318,25,30,0.833
1/5/2018,15,BOS,MIN,W ,91,84,240,38,94,0.404,32,58,0.552,6,36,0.167,9,13,0.692,28,76,0.368,21,53,0.396,7,23,0.304,21,28,0.75
1/5/2018,8,DAL,CHI,L ,124,127,240,49,92,0.533,35,60,0.583,14,32,0.438,12,17,0.706,44,78,0.564,30,50,0.6,14,28,0.5,25,31,0.806
1/5/2018,13,DEN,UTA,W ,99,91,240,38,86,0.442,24,51,0.471,14,35,0.4,9,15,0.6,38,84,0.452,26,51,0.51,12,33,0.364,3,6,0.5
1/5/2018,1,LAL,CHO,L ,94,108,240,38,94,0.404,29,58,0.5,9,36,0.25,9,12,0.75,42,99,0.424,30,66,0.455,12,33,0.364,12,16,0.75
1/5/2018,4,MEM,WAS,L ,100,102,240,35,86,0.407,25,56,0.446,10,30,0.333,20,26,0.769,33,84,0.393,23,57,0.404,10,27,0.37,26,34,0.765
1/5/2018,15,MIA,NYK,W ,107,103,265,38,94,0.404,26,52,0.5,12,42,0.286,19,20,0.95,39,80,0.488,34,67,0.507,5,13,0.385,20,23,0.87
1/5/2018,10,MIL,TOR,L ,110,129,240,41,77,0.532,34,60,0.567,7,17,0.412,21,29,0.724,48,86,0.558,38,53,0.717,10,33,0.303,23,28,0.821
1/5/2018,1,PHI,DET,W ,114,78,240,44,90,0.489,30,60,0.5,14,30,0.467,12,13,0.923,30,78,0.385,23,56,0.411,7,22,0.318,11,19,0.579
1/5/2018,6,POR,ATL,W ,110,89,240,43,80,0.538,30,50,0.6,13,30,0.433,11,14,0.786,30,83,0.361,22,57,0.386,8,26,0.308,21,25,0.84
1/5/2018,8,SAS,PHO,W ,103,89,240,41,87,0.471,30,57,0.526,11,30,0.367,10,18,0.556,35,83,0.422,28,53,0.528,7,30,0.233,12,18,0.667
1/4/2018,14,HOU,GSW,L ,114,124,240,42,89,0.472,25,39,0.641,17,50,0.34,13,22,0.591,48,87,0.552,35,57,0.614,13,30,0.433,15,20,0.75
1/4/2018,7,LAC,OKC,L ,117,127,240,45,100,0.45,36,70,0.514,9,30,0.3,18,23,0.783,51,95,0.537,36,61,0.59,15,34,0.441,10,14,0.714
1/3/2018,5,BOS,CLE,W ,102,88,240,41,92,0.446,29,56,0.518,12,36,0.333,8,11,0.727,31,89,0.348,23,57,0.404,8,32,0.25,18,18,1
1/3/2018,7,BRK,MIN,W ,98,97,240,37,72,0.514,23,42,0.548,14,30,0.467,10,11,0.909,36,80,0.45,35,69,0.507,1,11,0.091,24,30,0.8
1/3/2018,20,CHI,TOR,L ,115,124,240,43,93,0.462,30,60,0.5,13,33,0.394,16,19,0.842,45,92,0.489,30,54,0.556,15,38,0.395,19,19,1
1/3/2018,8,DAL,GSW,L ,122,125,240,43,90,0.478,24,47,0.511,19,43,0.442,17,22,0.773,48,91,0.527,35,59,0.593,13,32,0.406,16,19,0.842
1/3/2018,13,DEN,PHO,W ,134,111,240,51,82,0.622,39,55,0.709,12,27,0.444,20,22,0.909,39,92,0.424,26,57,0.456,13,35,0.371,20,28,0.714
1/3/2018,5,LAL,OKC,L ,96,133,240,38,92,0.413,27,59,0.458,11,33,0.333,9,15,0.6,56,93,0.602,42,63,0.667,14,30,0.467,7,9,0.778
1/3/2018,14,MIA,DET,W ,111,104,240,43,84,0.512,26,50,0.52,17,34,0.5,8,11,0.727,41,86,0.477,32,62,0.516,9,24,0.375,13,16,0.813
1/3/2018,3,MIL,IND,W ,122,101,240,44,75,0.587,35,58,0.603,9,17,0.529,25,28,0.893,41,84,0.488,38,69,0.551,3,15,0.2,16,19,0.842
1/3/2018,0,ORL,HOU,L ,98,116,240,35,91,0.385,29,60,0.483,6,31,0.194,22,25,0.88,42,89,0.472,27,55,0.491,15,34,0.441,17,21,0.81
1/3/2018,3,PHI,SAS,W ,112,106,240,36,80,0.45,29,58,0.5,7,22,0.318,33,43,0.767,39,87,0.448,31,62,0.5,8,25,0.32,20,23,0.87
1/3/2018,11,UTA,NOP,L ,98,108,240,38,84,0.452,31,52,0.596,7,32,0.219,15,17,0.882,41,82,0.5,27,52,0.519,14,30,0.467,12,12,1
1/3/2018,8,WAS,NYK,W ,121,103,240,48,81,0.593,39,58,0.672,9,23,0.391,16,26,0.615,41,86,0.477,34,67,0.507,7,19,0.368,14,18,0.778
1/2/2018,17,CLE,POR,W ,127,110,240,43,83,0.518,30,51,0.588,13,32,0.406,28,37,0.757,42,90,0.467,29,58,0.5,13,32,0.406,13,19,0.684
1/2/2018,8,LAC,MEM,W ,113,105,240,39,71,0.549,30,48,0.625,9,23,0.391,26,31,0.839,38,79,0.481,30,53,0.566,8,26,0.308,21,33,0.636
1/2/2018,14,NYK,SAS,L ,91,100,240,35,87,0.402,28,65,0.431,7,22,0.318,14,18,0.778,31,82,0.378,21,55,0.382,10,27,0.37,28,34,0.824
1/2/2018,10,PHO,ATL,W ,104,103,240,39,77,0.506,32,55,0.582,7,22,0.318,19,26,0.731,36,87,0.414,26,56,0.464,10,31,0.323,21,25,0.84
1/2/2018,2,SAC,CHO,L ,111,131,240,45,87,0.517,38,70,0.543,7,17,0.412,14,18,0.778,51,89,0.573,36,57,0.632,15,32,0.469,14,18,0.778
1/1/2018,13,BRK,ORL,W ,98,95,240,36,82,0.439,27,57,0.474,9,25,0.36,17,23,0.739,35,96,0.365,29,65,0.446,6,31,0.194,19,25,0.76
1/1/2018,8,CHI,POR,L ,120,124,265,45,104,0.433,34,77,0.442,11,27,0.407,19,23,0.826,47,108,0.435,33,75,0.44,14,33,0.424,16,18,0.889
1/1/2018,0,MIN,LAL,W ,114,96,240,40,81,0.494,33,61,0.541,7,20,0.35,27,30,0.9,34,76,0.447,26,50,0.52,8,26,0.308,20,29,0.69
1/1/2018,12,TOR,MIL,W ,131,127,265,45,91,0.495,31,58,0.534,14,33,0.424,27,33,0.818,44,93,0.473,31,66,0.47,13,27,0.481,26,28,0.929
12/31/2017,2,BOS,BRK,W ,108,105,240,39,79,0.494,25,46,0.543,14,33,0.424,16,25,0.64,39,95,0.411,28,59,0.475,11,36,0.306,16,19,0.842
12/31/2017,23,HOU,LAL,W ,148,142,290,49,106,0.462,31,54,0.574,18,52,0.346,32,39,0.821,53,105,0.505,43,80,0.538,10,25,0.4,26,37,0.703
12/31/2017,0,IND,MIN,L ,90,107,240,33,85,0.388,23,60,0.383,10,25,0.4,14,18,0.778,41,86,0.477,37,67,0.552,4,19,0.211,21,25,0.84
12/31/2017,8,LAC,CHO,W ,106,98,240,36,76,0.474,26,48,0.542,10,28,0.357,24,27,0.889,36,93,0.387,25,60,0.417,11,33,0.333,15,19,0.789
12/31/2017,21,OKC,DAL,L ,113,116,240,43,89,0.483,33,57,0.579,10,32,0.313,17,23,0.739,46,89,0.517,31,55,0.564,15,34,0.441,9,14,0.643
12/31/2017,4,PHO,PHI,L ,110,123,240,37,88,0.42,27,61,0.443,10,27,0.37,26,34,0.765,43,77,0.558,33,53,0.623,10,24,0.417,27,34,0.794
12/31/2017,1,SAC,MEM,L ,96,114,240,37,86,0.43,28,62,0.452,9,24,0.375,13,25,0.52,41,76,0.539,27,46,0.587,14,30,0.467,18,24,0.75
12/31/2017,9,WAS,CHI,W ,114,110,240,43,93,0.462,27,57,0.474,16,36,0.444,12,17,0.706,42,92,0.457,34,57,0.596,8,35,0.229,18,22,0.818
12/30/2017,9,ATL,POR,W ,104,89,240,40,89,0.449,26,59,0.441,14,30,0.467,10,15,0.667,36,85,0.424,29,60,0.483,7,25,0.28,10,13,0.769
12/30/2017,6,DEN,PHI,L ,102,107,240,35,87,0.402,28,55,0.509,7,32,0.219,25,34,0.735,45,93,0.484,37,69,0.536,8,24,0.333,9,10,0.9
12/30/2017,0,DET,SAS,W ,93,79,240,36,81,0.444,28,57,0.491,8,24,0.333,13,16,0.813,31,84,0.369,26,58,0.448,5,26,0.192,12,13,0.923
12/30/2017,2,GSW,MEM,W ,141,128,240,50,85,0.588,32,52,0.615,18,33,0.545,23,25,0.92,49,94,0.521,34,73,0.466,15,21,0.714,15,22,0.682
12/30/2017,6,NOP,NYK,L ,103,105,240,38,84,0.452,32,58,0.552,6,26,0.231,21,27,0.778,41,94,0.436,36,75,0.48,5,19,0.263,18,21,0.857
12/30/2017,2,ORL,MIA,L ,111,117,240,44,81,0.543,32,54,0.593,12,27,0.444,11,15,0.733,45,88,0.511,33,64,0.516,12,24,0.5,15,18,0.833
12/30/2017,4,UTA,CLE,W ,104,101,240,38,82,0.463,28,51,0.549,10,31,0.323,18,21,0.857,34,81,0.42,22,41,0.537,12,40,0.3,21,26,0.808
12/29/2017,2,CHI,IND,W ,119,107,240,43,85,0.506,25,46,0.543,18,39,0.462,15,15,1,43,93,0.462,36,71,0.507,7,22,0.318,14,20,0.7
12/29/2017,8,GSW,CHO,L ,100,111,240,40,87,0.46,32,65,0.492,8,22,0.364,12,13,0.923,41,89,0.461,35,69,0.507,6,20,0.3,23,34,0.676
12/29/2017,0,LAL,LAC,L ,106,121,240,46,94,0.489,43,75,0.573,3,19,0.158,11,16,0.688,42,86,0.488,33,54,0.611,9,32,0.281,28,34,0.824
12/29/2017,1,MIA,BRK,L ,87,111,240,30,89,0.337,27,63,0.429,3,26,0.115,24,31,0.774,39,79,0.494,28,53,0.528,11,26,0.423,22,25,0.88
12/29/2017,0,NOP,DAL,L ,120,128,240,42,85,0.494,34,54,0.63,8,31,0.258,28,32,0.875,46,83,0.554,24,44,0.545,22,39,0.564,14,18,0.778
12/29/2017,0,OKC,MIL,L ,95,97,240,38,83,0.458,31,58,0.534,7,25,0.28,12,20,0.6,40,85,0.471,31,56,0.554,9,29,0.31,8,17,0.471
12/29/2017,9,SAC,PHO,L ,101,111,240,37,80,0.463,29,57,0.509,8,23,0.348,19,23,0.826,41,85,0.482,28,55,0.509,13,30,0.433,16,24,0.667
12/29/2017,5,TOR,ATL,W ,111,98,240,46,105,0.438,33,68,0.485,13,37,0.351,6,8,0.75,38,88,0.432,29,64,0.453,9,24,0.375,13,20,0.65
12/29/2017,1,WAS,HOU,W ,121,103,240,47,88,0.534,29,52,0.558,18,36,0.5,9,12,0.75,38,89,0.427,24,41,0.585,14,48,0.292,13,16,0.813
12/28/2017,1,BOS,HOU,W ,99,98,240,37,82,0.451,29,53,0.547,8,29,0.276,17,24,0.708,30,80,0.375,16,37,0.432,14,43,0.326,24,31,0.774
12/28/2017,1,MIL,MIN,W ,102,96,240,41,75,0.547,36,60,0.6,5,15,0.333,15,16,0.938,34,71,0.479,25,43,0.581,9,28,0.321,19,26,0.731
12/28/2017,8,ORL,DET,W ,102,89,240,37,82,0.451,26,56,0.464,11,26,0.423,17,17,1,35,87,0.402,26,64,0.406,9,23,0.391,10,14,0.714
12/28/2017,5,POR,PHI,W ,114,110,240,35,75,0.467,27,51,0.529,8,24,0.333,36,47,0.766,42,87,0.483,26,55,0.473,16,32,0.5,10,14,0.714
12/28/2017,2,SAS,NYK,W ,119,107,240,41,80,0.513,32,60,0.533,9,20,0.45,28,39,0.718,41,90,0.456,36,76,0.474,5,14,0.357,20,22,0.909
12/27/2017,5,ATL,WAS,W ,113,99,240,41,94,0.436,30,57,0.526,11,37,0.297,20,29,0.69,35,81,0.432,26,57,0.456,9,24,0.375,20,26,0.769
12/27/2017,7,CHI,NYK,W ,92,87,240,35,86,0.407,25,58,0.431,10,28,0.357,12,16,0.75,37,91,0.407,33,68,0.485,4,23,0.174,9,13,0.692
12/27/2017,0,CHO,BOS,L ,91,102,240,32,87,0.368,25,64,0.391,7,23,0.304,20,29,0.69,37,78,0.474,22,44,0.5,15,34,0.441,13,13,1
12/27/2017,10,GSW,UTA,W ,126,101,240,51,86,0.593,40,63,0.635,11,23,0.478,13,17,0.765,37,92,0.402,31,69,0.449,6,23,0.261,21,27,0.778
12/27/2017,7,IND,DAL,L ,94,98,240,38,79,0.481,28,54,0.519,10,25,0.4,8,10,0.8,40,78,0.513,32,49,0.653,8,29,0.276,10,15,0.667
12/27/2017,6,LAL,MEM,L ,99,109,240,35,93,0.376,27,65,0.415,8,28,0.286,21,33,0.636,35,71,0.493,30,50,0.6,5,21,0.238,34,39,0.872
12/27/2017,8,MIN,DEN,W ,128,125,265,47,90,0.522,35,61,0.574,12,29,0.414,22,30,0.733,42,91,0.462,27,52,0.519,15,39,0.385,26,31,0.839
12/27/2017,3,NOP,BRK,W ,128,113,240,48,90,0.533,31,57,0.544,17,33,0.515,15,19,0.789,41,90,0.456,22,52,0.423,19,38,0.5,12,14,0.857
12/27/2017,2,OKC,TOR,W ,124,107,240,46,87,0.529,37,62,0.597,9,25,0.36,23,33,0.697,36,85,0.424,25,47,0.532,11,38,0.289,24,26,0.923
12/27/2017,8,SAC,CLE,W ,109,95,240,41,79,0.519,29,49,0.592,12,30,0.4,15,18,0.833,32,74,0.432,20,43,0.465,12,31,0.387,19,25,0.76
12/26/2017,7,DAL,TOR,W ,98,93,240,40,94,0.426,34,70,0.486,6,24,0.25,12,16,0.75,30,89,0.337,21,58,0.362,9,31,0.29,24,32,0.75
12/26/2017,5,DEN,UTA,W ,107,83,240,39,81,0.481,28,51,0.549,11,30,0.367,18,22,0.818,27,84,0.321,17,49,0.347,10,35,0.286,19,23,0.826
12/26/2017,0,DET,IND,W ,107,83,240,41,82,0.5,29,48,0.604,12,34,0.353,13,16,0.813,34,77,0.442,28,56,0.5,6,21,0.286,9,13,0.692
12/26/2017,10,LAC,SAC,W ,122,95,240,44,81,0.543,31,50,0.62,13,31,0.419,21,27,0.778,40,96,0.417,33,74,0.446,7,22,0.318,8,12,0.667
12/26/2017,6,MIA,ORL,W ,107,89,240,41,91,0.451,30,58,0.517,11,33,0.333,14,17,0.824,33,81,0.407,28,61,0.459,5,20,0.25,18,22,0.818
12/26/2017,7,MIL,CHI,L ,106,115,240,39,83,0.47,29,52,0.558,10,31,0.323,18,24,0.75,45,103,0.437,35,75,0.467,10,28,0.357,15,25,0.6
12/26/2017,6,PHO,MEM,W ,99,97,240,32,72,0.444,24,50,0.48,8,22,0.364,27,35,0.771,35,87,0.402,32,67,0.478,3,20,0.15,24,29,0.828
12/26/2017,7,SAS,BRK,W ,109,97,240,41,80,0.513,34,64,0.531,7,16,0.438,20,24,0.833,39,93,0.419,27,61,0.443,12,32,0.375,7,9,0.778
12/25/2017,4,BOS,WAS,L ,103,111,240,39,81,0.481,25,52,0.481,14,29,0.483,11,17,0.647,43,93,0.462,37,67,0.552,6,26,0.231,19,28,0.679
12/25/2017,7,GSW,CLE,W ,99,92,240,38,82,0.463,28,45,0.622,10,37,0.27,13,17,0.765,28,88,0.318,13,52,0.25,15,36,0.417,21,25,0.84
12/25/2017,8,LAL,MIN,L ,104,121,240,40,92,0.435,30,62,0.484,10,30,0.333,14,20,0.7,49,84,0.583,38,52,0.731,11,32,0.344,12,14,0.857
12/25/2017,18,NYK,PHI,L ,98,105,240,38,94,0.404,34,79,0.43,4,15,0.267,18,28,0.643,35,82,0.427,25,54,0.463,10,28,0.357,25,30,0.833
12/25/2017,14,OKC,HOU,W ,112,107,240,43,79,0.544,35,61,0.574,8,18,0.444,18,23,0.783,35,81,0.432,23,44,0.523,12,37,0.324,25,31,0.806
12/23/2017,18,ATL,DAL,W ,112,107,240,42,75,0.56,32,51,0.627,10,24,0.417,18,22,0.818,43,85,0.506,34,52,0.654,9,33,0.273,12,15,0.8
12/23/2017,10,BOS,CHI,W ,117,92,240,44,92,0.478,32,60,0.533,12,32,0.375,17,21,0.81,34,86,0.395,27,67,0.403,7,19,0.368,17,25,0.68
12/23/2017,14,CHO,MIL,W ,111,106,240,36,74,0.486,27,53,0.509,9,21,0.429,30,40,0.75,42,87,0.483,34,61,0.557,8,26,0.308,14,17,0.824
12/23/2017,7,GSW,DEN,L ,81,96,240,32,84,0.381,29,57,0.509,3,27,0.111,14,17,0.824,38,82,0.463,31,54,0.574,7,28,0.25,13,15,0.867
12/23/2017,7,IND,BRK,W ,123,119,265,47,90,0.522,37,67,0.552,10,23,0.435,19,24,0.792,42,98,0.429,26,62,0.419,16,36,0.444,19,25,0.76
12/23/2017,6,LAL,POR,L ,92,95,240,36,85,0.424,28,60,0.467,8,25,0.32,12,20,0.6,39,95,0.411,29,70,0.414,10,25,0.4,7,14,0.5
12/23/2017,3,MEM,LAC,W ,115,112,240,40,90,0.444,27,59,0.458,13,31,0.419,22,25,0.88,39,79,0.494,26,45,0.578,13,34,0.382,21,28,0.75
12/23/2017,8,MIA,NOP,L ,94,109,240,36,85,0.424,26,53,0.491,10,32,0.313,12,15,0.8,39,73,0.534,24,48,0.5,15,25,0.6,16,19,0.842
12/23/2017,0,PHO,MIN,L ,106,115,240,40,86,0.465,29,54,0.537,11,32,0.344,15,24,0.625,42,84,0.5,36,68,0.529,6,16,0.375,25,29,0.862
12/23/2017,14,SAC,SAS,L ,99,108,240,40,86,0.465,28,64,0.438,12,22,0.545,7,11,0.636,44,88,0.5,33,65,0.508,11,23,0.478,9,11,0.818
12/23/2017,7,TOR,PHI,W ,102,86,240,35,85,0.412,26,58,0.448,9,27,0.333,23,26,0.885,33,80,0.413,26,53,0.491,7,27,0.259,13,20,0.65
12/23/2017,2,UTA,OKC,L ,89,103,240,33,72,0.458,27,46,0.587,6,26,0.231,17,20,0.85,39,88,0.443,27,59,0.458,12,29,0.414,13,16,0.813
12/23/2017,6,WAS,ORL,W ,130,103,240,47,86,0.547,31,56,0.554,16,30,0.533,20,23,0.87,42,87,0.483,34,61,0.557,8,26,0.308,11,17,0.647
12/22/2017,0,BRK,WAS,W ,119,84,240,44,88,0.5,30,47,0.638,14,41,0.341,17,21,0.81,34,93,0.366,29,73,0.397,5,20,0.25,11,15,0.733
12/22/2017,4,DET,NYK,W ,104,101,240,38,88,0.432,28,63,0.444,10,25,0.4,18,25,0.72,44,97,0.454,36,73,0.493,8,24,0.333,5,6,0.833
12/22/2017,9,GSW,LAL,W ,113,106,240,42,85,0.494,35,61,0.574,7,24,0.292,22,27,0.815,40,94,0.426,29,65,0.446,11,29,0.379,15,22,0.682
12/22/2017,3,HOU,LAC,L ,118,128,240,36,78,0.462,19,38,0.5,17,40,0.425,29,35,0.829,43,91,0.473,25,49,0.51,18,42,0.429,24,31,0.774
12/22/2017,0,MIA,DAL,W ,113,101,240,46,72,0.639,30,47,0.638,16,25,0.64,5,6,0.833,38,75,0.507,21,40,0.525,17,35,0.486,8,11,0.727
12/22/2017,13,MIL,CHO,W ,109,104,240,41,87,0.471,33,58,0.569,8,29,0.276,19,23,0.826,39,88,0.443,27,62,0.435,12,26,0.462,14,17,0.824
12/22/2017,8,OKC,ATL,W ,120,117,240,44,82,0.537,31,57,0.544,13,25,0.52,19,31,0.613,44,85,0.518,29,53,0.547,15,32,0.469,14,17,0.824
12/22/2017,0,ORL,NOP,L ,97,111,240,36,85,0.424,32,65,0.492,4,20,0.2,21,29,0.724,43,86,0.5,33,56,0.589,10,30,0.333,15,24,0.625
12/22/2017,3,POR,DEN,L ,85,102,240,35,83,0.422,29,61,0.475,6,22,0.273,9,16,0.563,42,85,0.494,35,60,0.583,7,25,0.28,11,15,0.733
12/21/2017,26,CLE,CHI,W ,115,112,240,42,82,0.512,30,53,0.566,12,29,0.414,19,22,0.864,47,85,0.553,35,54,0.648,12,31,0.387,6,8,0.75
12/21/2017,4,NYK,BOS,W ,102,93,240,36,79,0.456,28,65,0.431,8,14,0.571,22,26,0.846,33,86,0.384,20,48,0.417,13,38,0.342,14,19,0.737
12/21/2017,13,PHI,TOR,L ,109,114,240,45,86,0.523,36,57,0.632,9,29,0.31,10,14,0.714,35,85,0.412,23,50,0.46,12,35,0.343,32,35,0.914
12/21/2017,13,PHO,MEM,W ,97,95,240,33,81,0.407,23,55,0.418,10,26,0.385,21,27,0.778,39,90,0.433,34,64,0.531,5,26,0.192,12,16,0.75
12/21/2017,4,UTA,SAS,W ,100,89,240,34,74,0.459,22,48,0.458,12,26,0.462,20,24,0.833,34,78,0.436,24,57,0.421,10,21,0.476,11,16,0.688
12/20/2017,13,ATL,IND,L ,95,105,240,35,81,0.432,27,52,0.519,8,29,0.276,17,20,0.85,40,82,0.488,33,61,0.541,7,21,0.333,18,19,0.947
12/20/2017,1,BOS,MIA,L ,89,90,240,30,80,0.375,17,48,0.354,13,32,0.406,16,21,0.762,33,75,0.44,23,47,0.489,10,28,0.357,14,25,0.56
12/20/2017,2,BRK,SAC,L ,99,104,240,32,82,0.39,17,40,0.425,15,42,0.357,20,23,0.87,40,82,0.488,33,63,0.524,7,19,0.368,17,20,0.85
12/20/2017,0,CHI,ORL,W ,112,94,240,44,87,0.506,33,55,0.6,11,32,0.344,13,14,0.929,35,89,0.393,30,62,0.484,5,27,0.185,19,23,0.826
12/20/2017,3,CHO,TOR,L ,111,129,240,39,85,0.459,32,62,0.516,7,23,0.304,26,35,0.743,49,91,0.538,33,58,0.569,16,33,0.485,15,18,0.833
12/20/2017,5,DAL,DET,W ,110,93,240,40,75,0.533,26,45,0.578,14,30,0.467,16,20,0.8,33,77,0.429,26,53,0.491,7,24,0.292,20,22,0.909
12/20/2017,8,DEN,MIN,L ,104,112,240,36,72,0.5,23,44,0.523,13,28,0.464,19,24,0.792,43,87,0.494,35,63,0.556,8,24,0.333,18,19,0.947
12/20/2017,1,GSW,MEM,W ,97,84,240,34,74,0.459,27,53,0.509,7,21,0.333,22,25,0.88,28,84,0.333,16,53,0.302,12,31,0.387,16,19,0.842
12/20/2017,6,HOU,LAL,L ,116,122,240,37,90,0.411,20,48,0.417,17,42,0.405,25,32,0.781,40,85,0.471,25,50,0.5,15,35,0.429,27,43,0.628
12/20/2017,0,LAC,PHO,W ,108,95,240,41,87,0.471,31,57,0.544,10,30,0.333,16,24,0.667,35,97,0.361,27,62,0.435,8,35,0.229,17,19,0.895
12/20/2017,0,OKC,UTA,W ,107,79,240,40,77,0.519,32,54,0.593,8,23,0.348,19,22,0.864,26,73,0.356,19,42,0.452,7,31,0.226,20,27,0.741
12/20/2017,14,POR,SAS,L ,91,93,240,38,96,0.396,32,71,0.451,6,25,0.24,9,14,0.643,41,79,0.519,35,62,0.565,6,17,0.353,5,6,0.833
12/19/2017,5,MIL,CLE,W ,119,116,240,43,82,0.524,32,53,0.604,11,29,0.379,22,27,0.815,40,80,0.5,24,39,0.615,16,41,0.39,20,24,0.833
12/19/2017,17,PHI,SAC,L ,95,101,240,34,81,0.42,24,46,0.522,10,35,0.286,17,24,0.708,41,91,0.451,34,64,0.531,7,27,0.259,12,23,0.522
12/19/2017,1,WAS,NOP,W ,116,106,240,46,92,0.5,32,57,0.561,14,35,0.4,10,14,0.714,34,80,0.425,29,60,0.483,5,20,0.25,33,40,0.825
12/18/2017,12,ATL,MIA,W ,110,104,240,38,83,0.458,30,61,0.492,8,22,0.364,26,31,0.839,36,79,0.456,29,54,0.537,7,25,0.28,25,30,0.833
12/18/2017,15,CHI,PHI,W ,117,115,240,44,92,0.478,31,64,0.484,13,28,0.464,16,19,0.842,44,91,0.484,30,58,0.517,14,33,0.424,13,18,0.722
12/18/2017,1,CHO,NYK,W ,109,91,240,43,88,0.489,34,68,0.5,9,20,0.45,14,16,0.875,36,86,0.419,33,68,0.485,3,18,0.167,16,20,0.8
12/18/2017,11,DAL,PHO,L ,91,97,240,32,88,0.364,21,51,0.412,11,37,0.297,16,17,0.941,35,79,0.443,25,54,0.463,10,25,0.4,17,22,0.773
12/18/2017,23,HOU,UTA,W ,120,99,240,40,77,0.519,23,34,0.676,17,43,0.395,23,27,0.852,42,91,0.462,34,64,0.531,8,27,0.296,7,8,0.875
12/18/2017,2,IND,BOS,L ,111,112,240,37,79,0.468,30,58,0.517,7,21,0.333,30,38,0.789,44,79,0.557,28,53,0.528,16,26,0.615,8,14,0.571
12/18/2017,12,LAL,GSW,L ,114,116,265,41,92,0.446,31,67,0.463,10,25,0.4,22,35,0.629,43,107,0.402,32,73,0.438,11,34,0.324,19,21,0.905
12/18/2017,21,MIN,POR,W ,108,107,240,42,91,0.462,35,72,0.486,7,19,0.368,17,21,0.81,46,84,0.548,36,60,0.6,10,24,0.417,5,5,1
12/18/2017,4,OKC,DEN,W ,95,94,240,39,81,0.481,32,57,0.561,7,24,0.292,10,15,0.667,37,86,0.43,25,49,0.51,12,37,0.324,8,12,0.667
12/18/2017,1,SAS,LAC,W ,109,91,240,40,82,0.488,31,58,0.534,9,24,0.375,20,25,0.8,37,84,0.44,28,55,0.509,9,29,0.31,8,16,0.5
12/17/2017,12,BRK,IND,L ,97,109,240,34,81,0.42,22,48,0.458,12,33,0.364,17,21,0.81,43,76,0.566,35,58,0.603,8,18,0.444,15,19,0.789
12/17/2017,0,DET,ORL,W ,114,110,240,42,89,0.472,25,55,0.455,17,34,0.5,13,16,0.813,41,85,0.482,24,52,0.462,17,33,0.515,11,17,0.647
12/17/2017,9,TOR,SAC,W ,108,93,240,36,85,0.424,23,55,0.418,13,30,0.433,23,28,0.821,38,81,0.469,27,55,0.491,11,26,0.423,6,8,0.75
12/17/2017,15,WAS,CLE,L ,99,106,240,39,91,0.429,27,58,0.466,12,33,0.364,9,16,0.563,41,87,0.471,27,53,0.509,14,34,0.412,10,12,0.833
12/16/2017,4,CHO,POR,L ,91,93,240,33,96,0.344,26,65,0.4,7,31,0.226,18,28,0.643,37,79,0.468,27,55,0.491,10,24,0.417,9,18,0.5
12/16/2017,5,CLE,UTA,W ,109,100,240,42,79,0.532,32,57,0.561,10,22,0.455,15,17,0.882,37,81,0.457,20,47,0.426,17,34,0.5,9,14,0.643
12/16/2017,16,HOU,MIL,W ,115,111,240,35,76,0.461,24,41,0.585,11,35,0.314,34,42,0.81,38,82,0.463,30,55,0.545,8,27,0.296,27,33,0.818
12/16/2017,6,MEM,BOS,L ,93,102,240,32,79,0.405,18,45,0.4,14,34,0.412,15,17,0.882,39,80,0.488,25,50,0.5,14,30,0.467,10,14,0.714
12/16/2017,4,MIA,LAC,W ,90,85,240,31,82,0.378,19,47,0.404,12,35,0.343,16,21,0.762,35,80,0.438,27,52,0.519,8,28,0.286,7,14,0.5
12/16/2017,7,MIN,PHO,L ,106,108,240,40,95,0.421,31,68,0.456,9,27,0.333,17,24,0.708,33,72,0.458,22,48,0.458,11,24,0.458,31,35,0.886
12/16/2017,8,NYK,OKC,W ,111,96,240,38,69,0.551,24,46,0.522,14,23,0.609,21,26,0.808,36,85,0.424,24,58,0.414,12,27,0.444,12,20,0.6
12/16/2017,0,SAS,DAL,W ,98,96,240,39,86,0.453,34,61,0.557,5,25,0.2,15,18,0.833,39,80,0.488,29,52,0.558,10,28,0.357,8,9,0.889
12/15/2017,6,BOS,UTA,L ,95,107,240,35,86,0.407,26,55,0.473,9,31,0.29,16,19,0.842,40,83,0.482,27,58,0.466,13,25,0.52,14,18,0.778
12/15/2017,3,CHO,MIA,L ,98,104,240,34,83,0.41,24,56,0.429,10,27,0.37,20,27,0.741,39,78,0.5,28,47,0.596,11,31,0.355,15,17,0.882
12/15/2017,10,DEN,NOP,W ,117,111,265,46,100,0.46,30,64,0.469,16,36,0.444,9,14,0.643,43,91,0.473,28,57,0.491,15,34,0.441,10,14,0.714
12/15/2017,0,HOU,SAS,W ,124,109,240,43,91,0.473,25,41,0.61,18,50,0.36,20,25,0.8,46,94,0.489,36,68,0.529,10,26,0.385,7,13,0.538
12/15/2017,7,IND,DET,L ,98,104,240,35,87,0.402,26,57,0.456,9,30,0.3,19,25,0.76,39,93,0.419,26,61,0.426,13,32,0.406,13,17,0.765
12/15/2017,9,MEM,ATL,W ,96,94,240,36,78,0.462,24,53,0.453,12,25,0.48,12,17,0.706,34,77,0.442,22,46,0.478,12,31,0.387,14,16,0.875
12/15/2017,15,MIL,CHI,L ,109,115,240,40,83,0.482,31,50,0.62,9,33,0.273,20,29,0.69,42,86,0.488,34,64,0.531,8,22,0.364,23,35,0.657
12/15/2017,1,ORL,POR,L ,88,95,240,32,84,0.381,22,55,0.4,10,29,0.345,14,19,0.737,37,86,0.43,29,68,0.426,8,18,0.444,13,15,0.867
12/15/2017,6,PHI,OKC,L ,117,119,315,44,100,0.44,31,54,0.574,13,46,0.283,16,20,0.8,47,113,0.416,32,78,0.41,15,35,0.429,10,19,0.526
12/15/2017,6,TOR,BRK,W ,120,87,240,54,97,0.557,47,69,0.681,7,28,0.25,5,9,0.556,32,76,0.421,25,53,0.472,7,23,0.304,16,19,0.842
12/15/2017,6,WAS,LAC,W ,100,91,240,39,88,0.443,32,57,0.561,7,31,0.226,15,23,0.652,33,86,0.384,26,62,0.419,7,24,0.292,18,29,0.621
12/14/2017,4,ATL,DET,L ,91,105,240,32,70,0.457,21,39,0.538,11,31,0.355,16,26,0.615,41,90,0.456,28,60,0.467,13,30,0.433,10,12,0.833
12/14/2017,6,BRK,NYK,L ,104,111,240,37,83,0.446,25,41,0.61,12,42,0.286,18,23,0.783,41,89,0.461,31,69,0.449,10,20,0.5,19,22,0.864
12/14/2017,5,CLE,LAL,W ,121,112,240,43,86,0.5,28,50,0.56,15,36,0.417,20,25,0.8,47,95,0.495,38,64,0.594,9,31,0.29,9,14,0.643
12/14/2017,10,GSW,DAL,W ,112,97,240,47,78,0.603,36,56,0.643,11,22,0.5,7,9,0.778,37,82,0.451,27,53,0.509,10,29,0.345,13,17,0.765
12/14/2017,1,MIN,SAC,W ,119,96,240,46,82,0.561,36,61,0.59,10,21,0.476,17,20,0.85,36,87,0.414,22,54,0.407,14,33,0.424,10,12,0.833
12/13/2017,6,BOS,DEN,W ,124,118,240,47,79,0.595,36,54,0.667,11,25,0.44,19,24,0.792,45,91,0.495,36,63,0.571,9,28,0.321,19,26,0.731
12/13/2017,16,CHI,UTA,W ,103,100,240,41,93,0.441,34,76,0.447,7,17,0.412,14,21,0.667,42,91,0.462,33,61,0.541,9,30,0.3,7,7,1
12/13/2017,4,HOU,CHO,W ,108,96,240,39,88,0.443,22,43,0.512,17,45,0.378,13,19,0.684,36,87,0.414,32,66,0.485,4,21,0.19,20,27,0.741
12/13/2017,12,IND,OKC,L ,95,100,240,40,89,0.449,29,58,0.5,11,31,0.355,4,6,0.667,36,88,0.409,23,59,0.39,13,29,0.448,15,24,0.625
12/13/2017,4,MIA,POR,L ,95,102,240,34,72,0.472,21,42,0.5,13,30,0.433,14,23,0.609,36,72,0.5,26,44,0.591,10,28,0.357,20,23,0.87
12/13/2017,17,NOP,MIL,W ,115,108,240,45,80,0.563,32,55,0.582,13,25,0.52,12,15,0.8,44,95,0.463,36,68,0.529,8,27,0.296,12,19,0.632
12/13/2017,4,ORL,LAC,L ,95,106,240,37,88,0.42,28,61,0.459,9,27,0.333,12,21,0.571,39,88,0.443,27,62,0.435,12,26,0.462,16,20,0.8
12/13/2017,5,PHO,TOR,L ,109,115,240,37,83,0.446,29,59,0.492,8,24,0.333,27,34,0.794,40,92,0.435,31,66,0.47,9,26,0.346,26,31,0.839
12/13/2017,2,WAS,MEM,W ,93,87,240,36,77,0.468,27,55,0.491,9,22,0.409,12,24,0.5,31,81,0.383,21,53,0.396,10,28,0.357,15,16,0.938
12/12/2017,21,BRK,WAS,W ,103,98,240,34,84,0.405,24,41,0.585,10,43,0.233,25,33,0.758,38,95,0.4,34,73,0.466,4,22,0.182,18,22,0.818
12/12/2017,8,CLE,ATL,W ,123,114,240,48,86,0.558,28,48,0.583,20,38,0.526,7,10,0.7,43,92,0.467,27,56,0.482,16,36,0.444,12,13,0.923
12/12/2017,3,DAL,SAS,W ,95,89,240,38,89,0.427,29,65,0.446,9,24,0.375,10,12,0.833,35,87,0.402,28,59,0.475,7,28,0.25,12,19,0.632
12/12/2017,0,DET,DEN,L ,84,103,240,28,79,0.354,19,54,0.352,9,25,0.36,19,22,0.864,40,79,0.506,30,49,0.612,10,30,0.333,13,14,0.929
12/12/2017,15,MIN,PHI,L ,112,118,265,44,108,0.407,39,79,0.494,5,29,0.172,19,27,0.704,40,80,0.5,29,54,0.537,11,26,0.423,27,32,0.844
12/12/2017,20,NYK,LAL,W ,113,109,265,48,101,0.475,39,79,0.494,9,22,0.409,8,11,0.727,42,102,0.412,29,67,0.433,13,35,0.371,12,15,0.8
12/12/2017,15,SAC,PHO,W ,99,92,240,38,89,0.427,31,67,0.463,7,22,0.318,16,22,0.727,37,90,0.411,30,58,0.517,7,32,0.219,11,14,0.786
12/11/2017,4,CHI,BOS,W ,108,85,240,39,81,0.481,27,52,0.519,12,29,0.414,18,25,0.72,33,83,0.398,23,43,0.535,10,40,0.25,9,14,0.643
12/11/2017,10,GSW,POR,W ,111,104,240,44,80,0.55,34,60,0.567,10,20,0.5,13,17,0.765,37,88,0.42,30,60,0.5,7,28,0.25,23,25,0.92
12/11/2017,17,HOU,NOP,W ,130,123,240,48,88,0.545,31,43,0.721,17,45,0.378,17,25,0.68,49,85,0.576,31,52,0.596,18,33,0.545,7,13,0.538
12/11/2017,2,LAC,TOR,W ,96,91,240,34,92,0.37,26,56,0.464,8,36,0.222,20,24,0.833,32,80,0.4,25,51,0.49,7,29,0.241,20,26,0.769
12/11/2017,5,MEM,MIA,L ,82,107,240,28,72,0.389,20,45,0.444,8,27,0.296,18,27,0.667,37,66,0.561,23,39,0.59,14,27,0.519,19,24,0.792
12/11/2017,9,OKC,CHO,L ,103,116,240,35,85,0.412,26,59,0.441,9,26,0.346,24,25,0.96,43,81,0.531,30,56,0.536,13,25,0.52,17,24,0.708
12/10/2017,1,DET,BOS,L ,81,91,240,28,84,0.333,18,51,0.353,10,33,0.303,15,19,0.789,33,79,0.418,22,49,0.449,11,30,0.367,14,18,0.778
12/10/2017,7,IND,DEN,W ,126,116,265,49,93,0.527,39,68,0.574,10,25,0.4,18,22,0.818,43,95,0.453,26,53,0.491,17,42,0.405,13,16,0.813
12/10/2017,21,MIN,DAL,W ,97,92,240,36,72,0.5,29,53,0.547,7,19,0.368,18,23,0.783,37,81,0.457,26,50,0.52,11,31,0.355,7,9,0.778
12/10/2017,12,NOP,PHI,W ,131,124,240,46,80,0.575,31,56,0.554,15,24,0.625,24,32,0.75,44,96,0.458,35,67,0.522,9,29,0.31,27,30,0.9
12/10/2017,3,NYK,ATL,W ,111,107,240,39,80,0.488,34,63,0.54,5,17,0.294,28,34,0.824,37,77,0.481,28,46,0.609,9,31,0.29,24,30,0.8
12/10/2017,6,SAC,TOR,L ,87,102,240,35,73,0.479,25,50,0.5,10,23,0.435,7,14,0.5,39,87,0.448,28,50,0.56,11,37,0.297,13,19,0.684
12/9/2017,8,ATL,ORL,W ,117,110,240,41,80,0.513,24,47,0.511,17,33,0.515,18,25,0.72,45,92,0.489,32,58,0.552,13,34,0.382,7,8,0.875
12/9/2017,9,BRK,MIA,L ,89,101,240,33,81,0.407,26,54,0.481,7,27,0.259,16,19,0.842,42,90,0.467,34,63,0.54,8,27,0.296,9,14,0.643
12/9/2017,13,CHI,NYK,W ,104,102,240,42,82,0.512,35,57,0.614,7,25,0.28,13,23,0.565,43,91,0.473,36,67,0.537,7,24,0.292,9,9,1
12/9/2017,19,CHO,LAL,L ,99,110,240,41,93,0.441,33,68,0.485,8,25,0.32,9,14,0.643,43,85,0.506,34,58,0.586,9,27,0.333,15,21,0.714
12/9/2017,5,CLE,PHI,W ,105,98,240,36,75,0.48,22,46,0.478,14,29,0.483,19,25,0.76,37,78,0.474,26,45,0.578,11,33,0.333,13,13,1
12/9/2017,17,LAC,WAS,W ,113,112,240,39,80,0.488,25,48,0.521,14,32,0.438,21,24,0.875,42,82,0.512,29,50,0.58,13,32,0.406,15,23,0.652
12/9/2017,12,MEM,OKC,L ,101,102,265,39,88,0.443,26,55,0.473,13,33,0.394,10,17,0.588,36,92,0.391,24,58,0.414,12,34,0.353,18,31,0.581
12/9/2017,1,MIL,UTA,W ,117,100,240,44,81,0.543,37,64,0.578,7,17,0.412,22,26,0.846,33,76,0.434,25,53,0.472,8,23,0.348,26,37,0.703
12/9/2017,2,PHO,SAS,L ,101,104,240,35,80,0.438,28,55,0.509,7,25,0.28,24,30,0.8,40,87,0.46,34,68,0.5,6,19,0.316,18,25,0.72
12/9/2017,8,POR,HOU,L ,117,124,240,45,88,0.511,27,47,0.574,18,41,0.439,9,12,0.75,40,75,0.533,30,50,0.6,10,25,0.4,34,42,0.81
12/8/2017,17,CHO,CHI,L ,111,119,265,40,100,0.4,30,71,0.423,10,29,0.345,21,29,0.724,48,99,0.485,42,81,0.519,6,18,0.333,17,22,0.773
12/8/2017,9,DET,GSW,L ,98,102,240,38,92,0.413,26,65,0.4,12,27,0.444,10,19,0.526,39,81,0.481,32,55,0.582,7,26,0.269,17,22,0.773
12/8/2017,14,IND,CLE,W ,106,102,240,38,86,0.442,23,47,0.489,15,39,0.385,15,24,0.625,37,85,0.435,26,49,0.531,11,36,0.306,17,22,0.773
12/8/2017,10,MEM,TOR,L ,107,116,240,41,82,0.5,32,55,0.582,9,27,0.333,16,22,0.727,37,78,0.474,24,47,0.511,13,31,0.419,29,33,0.879
12/8/2017,10,MIL,DAL,W ,109,102,240,36,79,0.456,28,55,0.509,8,24,0.333,29,34,0.853,35,75,0.467,25,51,0.49,10,24,0.417,22,26,0.846
12/8/2017,12,NOP,SAC,L ,109,116,265,41,89,0.461,31,61,0.508,10,28,0.357,17,19,0.895,47,97,0.485,34,67,0.507,13,30,0.433,9,14,0.643
12/8/2017,5,ORL,DEN,L ,89,103,240,33,83,0.398,28,62,0.452,5,21,0.238,18,23,0.783,42,85,0.494,36,64,0.563,6,21,0.286,13,16,0.813
12/8/2017,7,SAS,BOS,W ,105,102,240,38,81,0.469,30,54,0.556,8,27,0.296,21,24,0.875,38,83,0.458,27,45,0.6,11,38,0.289,15,17,0.882
12/7/2017,12,BRK,OKC,W ,100,95,240,35,80,0.438,24,43,0.558,11,37,0.297,19,30,0.633,38,98,0.388,31,74,0.419,7,24,0.292,12,23,0.522
12/7/2017,4,PHI,LAL,L ,104,107,240,39,81,0.481,29,55,0.527,10,26,0.385,16,21,0.762,42,96,0.438,31,68,0.456,11,28,0.393,12,24,0.5
12/7/2017,3,PHO,WAS,L ,99,109,240,36,78,0.462,29,55,0.527,7,23,0.304,20,28,0.714,41,81,0.506,33,60,0.55,8,21,0.381,19,25,0.76
12/7/2017,4,UTA,HOU,L ,101,112,240,34,77,0.442,23,47,0.489,11,30,0.367,22,27,0.815,38,81,0.469,20,39,0.513,18,42,0.429,18,24,0.75
12/6/2017,13,BOS,DAL,W ,97,90,240,36,87,0.414,24,53,0.453,12,34,0.353,13,17,0.765,34,86,0.395,25,58,0.431,9,28,0.321,13,17,0.765
12/6/2017,0,CHO,GSW,L ,87,101,240,34,97,0.351,28,78,0.359,6,19,0.316,13,17,0.765,40,84,0.476,29,54,0.537,11,30,0.367,10,13,0.769
12/6/2017,8,CLE,SAC,W ,101,95,240,37,78,0.474,23,39,0.59,14,39,0.359,13,21,0.619,39,86,0.453,29,54,0.537,10,32,0.313,7,13,0.538
12/6/2017,1,IND,CHI,W ,98,96,240,39,87,0.448,27,53,0.509,12,34,0.353,8,10,0.8,39,83,0.47,29,57,0.509,10,26,0.385,8,16,0.5
12/6/2017,0,LAC,MIN,L ,107,113,240,44,99,0.444,34,67,0.507,10,32,0.313,9,15,0.6,45,82,0.549,38,63,0.603,7,19,0.368,16,21,0.762
12/6/2017,10,MIL,DET,W ,104,100,240,39,79,0.494,31,57,0.544,8,22,0.364,18,26,0.692,36,87,0.414,26,57,0.456,10,30,0.333,18,27,0.667
12/6/2017,14,NOP,DEN,W ,123,114,240,46,86,0.535,34,55,0.618,12,31,0.387,19,29,0.655,41,94,0.436,25,59,0.424,16,35,0.457,16,22,0.727
12/6/2017,6,NYK,MEM,W ,99,88,240,35,67,0.522,26,53,0.491,9,14,0.643,20,27,0.741,29,70,0.414,17,42,0.405,12,28,0.429,18,22,0.818
12/6/2017,9,ORL,ATL,W ,110,106,265,46,98,0.469,40,70,0.571,6,28,0.214,12,18,0.667,40,93,0.43,29,66,0.439,11,27,0.407,15,20,0.75
12/6/2017,5,SAS,MIA,W ,117,105,240,46,87,0.529,33,62,0.532,13,25,0.52,12,14,0.857,39,72,0.542,21,38,0.553,18,34,0.529,9,12,0.75
12/5/2017,4,OKC,UTA,W ,100,94,240,39,81,0.481,35,63,0.556,4,18,0.222,18,26,0.692,34,79,0.43,23,46,0.5,11,33,0.333,15,21,0.714
12/5/2017,3,POR,WAS,L ,92,106,240,32,78,0.41,20,51,0.392,12,27,0.444,16,21,0.762,42,89,0.472,31,64,0.484,11,25,0.44,11,14,0.786
12/5/2017,3,TOR,PHO,W ,126,113,240,44,92,0.478,29,56,0.518,15,36,0.417,23,26,0.885,37,75,0.493,28,51,0.549,9,24,0.375,30,38,0.789
12/4/2017,11,ATL,BRK,L ,90,110,240,30,82,0.366,21,52,0.404,9,30,0.3,21,27,0.778,41,85,0.482,26,49,0.531,15,36,0.417,13,15,0.867
12/4/2017,2,BOS,MIL,W ,111,100,240,43,78,0.551,33,56,0.589,10,22,0.455,15,19,0.789,35,78,0.449,26,57,0.456,9,21,0.429,21,24,0.875
12/4/2017,1,CHI,CLE,L ,91,113,240,34,82,0.415,25,48,0.521,9,34,0.265,14,18,0.778,42,81,0.519,29,45,0.644,13,36,0.361,16,17,0.941
12/4/2017,5,CHO,ORL,W ,104,94,240,34,84,0.405,31,67,0.463,3,17,0.176,33,40,0.825,36,82,0.439,26,50,0.52,10,32,0.313,12,14,0.857
12/4/2017,0,DAL,DEN,W ,122,105,240,49,86,0.57,37,60,0.617,12,26,0.462,12,17,0.706,38,91,0.418,24,55,0.436,14,36,0.389,15,23,0.652
12/4/2017,0,IND,NYK,W ,115,97,240,46,86,0.535,35,60,0.583,11,26,0.423,12,15,0.8,40,91,0.44,34,68,0.5,6,23,0.261,11,16,0.688
12/4/2017,14,MEM,MIN,W ,95,92,240,34,72,0.472,28,51,0.549,6,21,0.286,21,24,0.875,35,79,0.443,31,62,0.5,4,17,0.235,18,19,0.947
12/4/2017,11,NOP,GSW,L ,115,125,240,45,91,0.495,29,52,0.558,16,39,0.41,9,15,0.6,45,87,0.517,29,54,0.537,16,33,0.485,19,27,0.704
12/4/2017,10,PHI,PHO,L ,101,115,240,39,91,0.429,32,61,0.525,7,30,0.233,16,16,1,44,91,0.484,34,69,0.493,10,22,0.455,17,22,0.773
12/4/2017,11,SAS,DET,W ,96,93,240,35,82,0.427,21,51,0.412,14,31,0.452,12,12,1,35,85,0.412,27,58,0.466,8,27,0.296,15,24,0.625
12/4/2017,3,UTA,WAS,W ,116,69,240,43,76,0.566,27,42,0.643,16,34,0.471,14,18,0.778,23,80,0.288,19,60,0.317,4,20,0.2,19,23,0.826
12/3/2017,6,LAL,HOU,L ,95,118,240,32,84,0.381,23,56,0.411,9,28,0.321,22,30,0.733,45,90,0.5,31,53,0.585,14,37,0.378,14,17,0.824
12/3/2017,13,MIA,GSW,L ,95,123,240,33,81,0.407,19,44,0.432,14,37,0.378,15,17,0.882,47,84,0.56,36,54,0.667,11,30,0.367,18,24,0.75
12/3/2017,13,MIN,LAC,W ,112,106,240,38,88,0.432,30,62,0.484,8,26,0.308,28,31,0.903,37,73,0.507,22,39,0.564,15,34,0.441,17,22,0.773
12/3/2017,10,NYK,ORL,L ,100,105,240,43,93,0.462,38,78,0.487,5,15,0.333,9,10,0.9,37,82,0.451,31,54,0.574,6,28,0.214,25,29,0.862
12/3/2017,4,OKC,SAS,W ,90,87,240,37,87,0.425,31,65,0.477,6,22,0.273,10,21,0.476,31,76,0.408,23,48,0.479,8,28,0.286,17,23,0.739
12/2/2017,9,BOS,PHO,W ,116,111,240,42,80,0.525,28,49,0.571,14,31,0.452,18,23,0.783,48,101,0.475,41,77,0.532,7,24,0.292,8,11,0.727
12/2/2017,8,BRK,ATL,L ,102,114,240,34,82,0.415,17,40,0.425,17,42,0.405,17,21,0.81,47,99,0.475,37,72,0.514,10,27,0.37,10,14,0.714
12/2/2017,7,CLE,MEM,W ,116,111,240,42,75,0.56,31,51,0.608,11,24,0.458,21,23,0.913,43,84,0.512,30,61,0.492,13,23,0.565,12,14,0.857
12/2/2017,0,DAL,LAC,W ,108,82,240,36,79,0.456,20,44,0.455,16,35,0.457,20,26,0.769,30,86,0.349,24,64,0.375,6,22,0.273,16,23,0.696
12/2/2017,7,DEN,LAL,W ,115,100,240,40,87,0.46,28,56,0.5,12,31,0.387,23,28,0.821,38,86,0.442,29,56,0.518,9,30,0.3,15,21,0.714
12/2/2017,0,MIL,SAC,W ,109,104,240,34,69,0.493,28,50,0.56,6,19,0.316,35,42,0.833,37,77,0.481,26,53,0.491,11,24,0.458,19,21,0.905
12/2/2017,8,PHI,DET,W ,108,103,240,35,86,0.407,25,58,0.431,10,28,0.357,28,32,0.875,34,78,0.436,25,47,0.532,9,31,0.29,26,32,0.813
12/2/2017,3,POR,NOP,L ,116,123,240,47,105,0.448,36,70,0.514,11,35,0.314,11,11,1,45,86,0.523,30,55,0.545,15,31,0.484,18,25,0.72
12/1/2017,22,CHI,SAC,L ,106,107,240,42,90,0.467,29,54,0.537,13,36,0.361,9,13,0.692,45,85,0.529,39,67,0.582,6,18,0.333,11,14,0.786
12/1/2017,2,MEM,SAS,L ,79,95,240,30,74,0.405,25,59,0.424,5,15,0.333,14,18,0.778,31,70,0.443,20,43,0.465,11,27,0.407,22,32,0.688
12/1/2017,19,MIA,CHO,W ,105,100,240,39,80,0.488,25,45,0.556,14,35,0.4,13,21,0.619,38,79,0.481,33,59,0.559,5,20,0.25,19,21,0.905
12/1/2017,0,OKC,MIN,W ,111,107,240,41,79,0.519,33,53,0.623,8,26,0.308,21,22,0.955,39,76,0.513,27,52,0.519,12,24,0.5,17,21,0.81
12/1/2017,0,ORL,GSW,L ,112,133,240,44,96,0.458,33,68,0.485,11,28,0.393,13,18,0.722,55,88,0.625,43,64,0.672,12,24,0.5,11,11,1
12/1/2017,12,TOR,IND,W ,120,115,240,48,97,0.495,38,65,0.585,10,32,0.313,14,21,0.667,45,102,0.441,37,76,0.487,8,26,0.308,17,22,0.773
12/1/2017,13,UTA,NOP,W ,114,108,240,42,85,0.494,30,55,0.545,12,30,0.4,18,25,0.72,42,87,0.483,27,57,0.474,15,30,0.5,9,15,0.6
12/1/2017,9,WAS,DET,W ,109,91,240,43,89,0.483,36,68,0.529,7,21,0.333,16,19,0.842,35,79,0.443,26,49,0.531,9,30,0.3,12,19,0.632
11/30/2017,11,ATL,CLE,L ,114,121,240,41,79,0.519,29,48,0.604,12,31,0.387,20,24,0.833,41,79,0.519,23,40,0.575,18,39,0.462,21,27,0.778
11/30/2017,5,BOS,PHI,W ,108,97,240,40,79,0.506,28,50,0.56,12,29,0.414,16,20,0.8,35,84,0.417,19,52,0.365,16,32,0.5,11,18,0.611
11/30/2017,10,DEN,CHI,W ,111,110,240,38,83,0.458,26,52,0.5,12,31,0.387,23,31,0.742,44,82,0.537,35,58,0.603,9,24,0.375,13,21,0.619
11/30/2017,7,LAC,UTA,L ,107,126,240,38,70,0.543,28,41,0.683,10,29,0.345,21,30,0.7,49,85,0.576,32,50,0.64,17,35,0.486,11,14,0.786
11/30/2017,1,POR,MIL,L ,91,103,240,35,83,0.422,29,60,0.483,6,23,0.261,15,17,0.882,42,87,0.483,36,67,0.537,6,20,0.3,13,15,0.867
11/29/2017,7,DAL,BRK,L ,104,109,240,39,84,0.464,30,57,0.526,9,27,0.333,17,21,0.81,42,90,0.467,31,61,0.508,11,29,0.379,14,25,0.56
11/29/2017,0,DET,PHO,W ,131,107,240,51,89,0.573,38,61,0.623,13,28,0.464,16,21,0.762,39,84,0.464,32,62,0.516,7,22,0.318,22,28,0.786
11/29/2017,7,HOU,IND,W ,118,97,240,42,86,0.488,24,46,0.522,18,40,0.45,16,21,0.762,42,88,0.477,35,60,0.583,7,28,0.25,6,6,1
11/29/2017,14,LAL,GSW,L ,123,127,265,47,95,0.495,38,71,0.535,9,24,0.375,20,25,0.8,47,94,0.5,35,64,0.547,12,30,0.4,21,28,0.75
11/29/2017,1,NOP,MIN,L ,102,120,240,39,84,0.464,25,49,0.51,14,35,0.4,10,11,0.909,47,81,0.58,38,58,0.655,9,23,0.391,17,19,0.895
11/29/2017,4,NYK,MIA,W ,115,86,240,44,73,0.603,39,60,0.65,5,13,0.385,22,26,0.846,32,84,0.381,22,46,0.478,10,38,0.263,12,20,0.6
11/29/2017,5,ORL,OKC,W ,121,108,240,45,76,0.592,32,46,0.696,13,30,0.433,18,26,0.692,38,96,0.396,26,64,0.406,12,32,0.375,20,30,0.667
11/29/2017,1,PHI,WAS,W ,118,113,240,37,81,0.457,34,63,0.54,3,18,0.167,41,64,0.641,36,89,0.404,27,67,0.403,9,22,0.409,32,37,0.865
11/29/2017,1,SAS,MEM,W ,104,95,240,38,75,0.507,30,55,0.545,8,20,0.4,20,24,0.833,35,77,0.455,24,55,0.436,11,22,0.5,14,16,0.875
11/29/2017,0,TOR,CHO,W ,126,113,240,52,98,0.531,38,66,0.576,14,32,0.438,8,11,0.727,37,79,0.468,28,60,0.467,9,19,0.474,30,35,0.857
11/28/2017,5,CHI,PHO,L ,99,104,240,38,94,0.404,22,54,0.407,16,40,0.4,7,10,0.7,38,87,0.437,27,57,0.474,11,30,0.367,17,23,0.739
11/28/2017,0,CLE,MIA,W ,108,97,240,40,81,0.494,29,48,0.604,11,33,0.333,17,23,0.739,37,84,0.44,27,53,0.509,10,31,0.323,13,20,0.65
11/28/2017,3,MIN,WAS,L ,89,92,240,35,85,0.412,25,55,0.455,10,30,0.333,9,14,0.643,36,83,0.434,26,55,0.473,10,28,0.357,10,17,0.588
11/28/2017,3,SAC,MIL,L ,87,112,240,31,77,0.403,26,60,0.433,5,17,0.294,20,29,0.69,42,71,0.592,33,49,0.673,9,22,0.409,19,31,0.613
11/28/2017,14,UTA,DEN,W ,106,77,240,42,87,0.483,28,55,0.509,14,32,0.438,8,9,0.889,28,78,0.359,21,44,0.477,7,34,0.206,14,16,0.875
11/27/2017,20,BOS,DET,L ,108,118,240,40,77,0.519,24,44,0.545,16,33,0.485,12,21,0.571,44,85,0.518,33,60,0.55,11,25,0.44,19,23,0.826
11/27/2017,16,GSW,SAC,L ,106,110,240,40,80,0.5,24,43,0.558,16,37,0.432,10,14,0.714,42,79,0.532,33,62,0.532,9,17,0.529,17,21,0.81
11/27/2017,2,HOU,BRK,W ,117,103,240,42,86,0.488,22,36,0.611,20,50,0.4,13,20,0.65,40,86,0.465,30,47,0.638,10,39,0.256,13,17,0.765
11/27/2017,11,IND,ORL,W ,121,109,240,42,79,0.532,27,53,0.509,15,26,0.577,22,26,0.846,40,92,0.435,24,51,0.471,16,41,0.39,13,16,0.813
11/27/2017,16,LAC,LAL,W ,120,115,240,41,85,0.482,31,57,0.544,10,28,0.357,28,30,0.933,44,91,0.484,33,61,0.541,11,30,0.367,16,24,0.667
11/27/2017,10,NYK,POR,L ,91,103,240,35,88,0.398,30,73,0.411,5,15,0.333,16,22,0.727,37,83,0.446,30,62,0.484,7,21,0.333,22,26,0.846
11/27/2017,3,PHI,CLE,L ,91,113,240,36,96,0.375,33,68,0.485,3,28,0.107,16,20,0.8,41,86,0.477,26,49,0.531,15,37,0.405,16,20,0.8
11/27/2017,4,SAS,DAL,W ,115,108,240,43,82,0.524,33,58,0.569,10,24,0.417,19,21,0.905,41,85,0.482,27,53,0.509,14,32,0.438,12,17,0.706
11/26/2017,16,CHI,MIA,L ,93,100,240,33,89,0.371,19,56,0.339,14,33,0.424,13,16,0.813,34,75,0.453,21,43,0.488,13,32,0.406,19,23,0.826
11/26/2017,1,MEM,BRK,L ,88,98,240,32,80,0.4,24,55,0.436,8,25,0.32,16,18,0.889,33,74,0.446,20,45,0.444,13,29,0.448,19,23,0.826
11/26/2017,6,MIN,PHO,W ,119,108,240,49,93,0.527,40,72,0.556,9,21,0.429,12,17,0.706,43,85,0.506,30,59,0.508,13,26,0.5,9,12,0.75
11/25/2017,4,ATL,TOR,L ,78,112,240,26,75,0.347,20,48,0.417,6,27,0.222,20,23,0.87,46,84,0.548,33,52,0.635,13,32,0.406,7,9,0.778
11/25/2017,9,CHO,SAS,L ,86,106,240,31,84,0.369,27,59,0.458,4,25,0.16,20,26,0.769,39,81,0.481,33,56,0.589,6,25,0.24,22,25,0.88
11/25/2017,3,DAL,OKC,W ,97,81,240,37,75,0.493,22,40,0.55,15,35,0.429,8,11,0.727,29,80,0.363,16,45,0.356,13,35,0.371,10,13,0.769
11/25/2017,1,GSW,NOP,W ,110,95,240,39,94,0.415,29,61,0.475,10,33,0.303,22,27,0.815,34,84,0.405,23,53,0.434,11,31,0.355,16,23,0.696
11/25/2017,8,HOU,NYK,W ,117,102,240,41,94,0.436,23,47,0.489,18,47,0.383,17,22,0.773,42,85,0.494,38,68,0.559,4,17,0.235,14,19,0.737
11/25/2017,3,IND,BOS,L ,98,108,240,38,78,0.487,31,55,0.564,7,23,0.304,15,15,1,45,80,0.563,35,55,0.636,10,25,0.4,8,9,0.889
11/25/2017,3,PHI,ORL,W ,130,111,240,48,95,0.505,32,61,0.525,16,34,0.471,18,20,0.9,39,86,0.453,27,55,0.491,12,31,0.387,21,31,0.677
11/25/2017,2,SAC,LAC,L ,95,97,240,38,83,0.458,27,62,0.435,11,21,0.524,8,9,0.889,38,80,0.475,29,52,0.558,9,28,0.321,12,13,0.923
11/25/2017,10,UTA,MIL,W ,121,108,240,46,81,0.568,28,49,0.571,18,32,0.563,11,19,0.579,41,77,0.532,33,56,0.589,8,21,0.381,18,23,0.783
11/25/2017,4,WAS,POR,L ,105,108,240,41,89,0.461,33,66,0.5,8,23,0.348,15,16,0.938,41,80,0.513,32,56,0.571,9,24,0.375,17,22,0.773
11/24/2017,4,ATL,NYK,W ,116,104,240,47,99,0.475,34,68,0.5,13,31,0.419,9,12,0.75,40,78,0.513,28,48,0.583,12,30,0.4,12,14,0.857
11/24/2017,7,BOS,ORL,W ,118,103,240,42,91,0.462,25,49,0.51,17,42,0.405,17,25,0.68,41,95,0.432,32,71,0.451,9,24,0.375,12,19,0.632
11/24/2017,17,BRK,POR,L ,125,127,240,50,100,0.5,40,75,0.533,10,25,0.4,15,21,0.714,48,96,0.5,42,81,0.519,6,15,0.4,25,35,0.714
11/24/2017,15,CLE,CHO,W ,100,99,240,38,83,0.458,25,44,0.568,13,39,0.333,11,15,0.733,36,94,0.383,25,65,0.385,11,29,0.379,16,27,0.593
11/24/2017,1,DEN,MEM,W ,104,92,240,40,79,0.506,31,47,0.66,9,32,0.281,15,26,0.577,36,73,0.493,27,49,0.551,9,24,0.375,11,16,0.688
11/24/2017,12,GSW,CHI,W ,143,94,240,53,91,0.582,37,55,0.673,16,36,0.444,21,21,1,35,99,0.354,22,63,0.349,13,36,0.361,11,15,0.733
11/24/2017,5,IND,TOR,W ,107,104,240,38,83,0.458,27,57,0.474,11,26,0.423,20,27,0.741,40,81,0.494,31,51,0.608,9,30,0.3,15,20,0.75
11/24/2017,1,MIN,MIA,L ,97,109,240,37,84,0.44,30,67,0.448,7,17,0.412,16,26,0.615,38,80,0.475,19,41,0.463,19,39,0.487,14,16,0.875
11/24/2017,3,OKC,DET,L ,98,99,240,42,98,0.429,34,66,0.515,8,32,0.25,6,8,0.75,39,84,0.464,25,47,0.532,14,37,0.378,7,9,0.778
11/24/2017,4,PHO,NOP,L ,91,115,240,37,94,0.394,35,74,0.473,2,20,0.1,15,18,0.833,45,91,0.495,36,64,0.563,9,27,0.333,16,22,0.727
11/22/2017,13,ATL,LAC,L ,103,116,240,40,83,0.482,30,54,0.556,10,29,0.345,13,15,0.867,44,76,0.579,29,46,0.63,15,30,0.5,13,19,0.684
11/22/2017,12,CHO,WAS,W ,129,124,265,43,91,0.473,33,63,0.524,10,28,0.357,33,40,0.825,48,99,0.485,37,66,0.561,11,33,0.333,17,22,0.773
11/22/2017,12,CLE,BRK,W ,119,109,240,43,82,0.524,29,48,0.604,14,34,0.412,19,27,0.704,42,81,0.519,28,44,0.636,14,37,0.378,11,16,0.688
11/22/2017,1,HOU,DEN,W ,125,95,240,45,82,0.549,27,41,0.659,18,41,0.439,17,23,0.739,35,87,0.402,25,54,0.463,10,33,0.303,15,23,0.652
11/22/2017,4,MEM,DAL,L ,94,95,240,37,81,0.457,30,52,0.577,7,29,0.241,13,14,0.929,39,91,0.429,30,63,0.476,9,28,0.321,8,16,0.5
11/22/2017,1,MIA,BOS,W ,104,98,240,40,81,0.494,30,53,0.566,10,28,0.357,14,16,0.875,35,84,0.417,26,58,0.448,9,26,0.346,19,27,0.704
11/22/2017,7,MIN,ORL,W ,124,118,240,40,87,0.46,32,64,0.5,8,23,0.348,36,45,0.8,46,91,0.505,34,54,0.63,12,37,0.324,14,22,0.636
11/22/2017,2,NOP,SAS,W ,107,90,240,39,81,0.481,32,57,0.561,7,24,0.292,22,24,0.917,35,88,0.398,29,64,0.453,6,24,0.25,14,15,0.933
11/22/2017,3,NYK,TOR,W ,108,100,240,43,93,0.462,35,69,0.507,8,24,0.333,14,17,0.824,37,87,0.425,23,49,0.469,14,38,0.368,12,18,0.667
11/22/2017,2,OKC,GSW,W ,108,91,240,41,90,0.456,33,65,0.508,8,25,0.32,18,26,0.692,33,80,0.413,23,49,0.469,10,31,0.323,15,18,0.833
11/22/2017,0,PHI,POR,W ,101,81,240,39,90,0.433,28,58,0.483,11,32,0.344,12,17,0.706,30,89,0.337,23,63,0.365,7,26,0.269,14,24,0.583
11/22/2017,10,PHO,MIL,L ,107,113,265,37,93,0.398,30,71,0.423,7,22,0.318,26,33,0.788,42,97,0.433,34,68,0.5,8,29,0.276,21,31,0.677
11/22/2017,3,SAC,LAL,W ,113,102,240,47,85,0.553,37,64,0.578,10,21,0.476,9,14,0.643,39,78,0.5,24,49,0.49,15,29,0.517,9,15,0.6
11/22/2017,11,UTA,CHI,W ,110,80,240,40,86,0.465,26,51,0.51,14,35,0.4,16,19,0.842,29,78,0.372,24,57,0.421,5,21,0.238,17,20,0.85
11/21/2017,10,LAL,CHI,W ,103,94,240,36,90,0.4,23,50,0.46,13,40,0.325,18,25,0.72,36,94,0.383,25,58,0.431,11,36,0.306,11,16,0.688
11/20/2017,20,CHO,MIN,W ,118,102,240,42,85,0.494,31,59,0.525,11,26,0.423,23,29,0.793,37,90,0.411,31,63,0.492,6,27,0.222,22,26,0.846
11/20/2017,3,DAL,BOS,L ,102,110,265,39,96,0.406,32,63,0.508,7,33,0.212,17,20,0.85,38,84,0.452,25,48,0.521,13,36,0.361,21,26,0.808
11/20/2017,8,DET,CLE,L ,88,116,240,34,77,0.442,21,47,0.447,13,30,0.433,7,13,0.538,42,80,0.525,26,47,0.553,16,33,0.485,16,17,0.941
11/20/2017,5,MEM,POR,L ,92,100,240,33,86,0.384,25,56,0.446,8,30,0.267,18,23,0.783,33,83,0.398,27,68,0.397,6,15,0.4,28,32,0.875
11/20/2017,8,MIL,WAS,L ,88,99,240,35,79,0.443,31,57,0.544,4,22,0.182,14,19,0.737,39,74,0.527,30,50,0.6,9,24,0.375,12,17,0.706
11/20/2017,7,NOP,OKC,W ,114,107,240,41,80,0.513,34,55,0.618,7,25,0.28,25,32,0.781,38,89,0.427,27,54,0.5,11,35,0.314,20,26,0.769
11/20/2017,12,NYK,LAC,W ,107,85,240,35,81,0.432,22,47,0.468,13,34,0.382,24,25,0.96,30,80,0.375,20,48,0.417,10,32,0.313,15,21,0.714
11/20/2017,15,ORL,IND,L ,97,105,240,35,84,0.417,22,46,0.478,13,38,0.342,14,23,0.609,37,89,0.416,29,69,0.42,8,20,0.4,23,29,0.793
11/20/2017,4,PHI,UTA,W ,107,86,240,44,85,0.518,40,70,0.571,4,15,0.267,15,22,0.682,30,85,0.353,21,57,0.368,9,28,0.321,17,19,0.895
11/20/2017,9,SAC,DEN,L ,98,114,240,41,86,0.477,33,66,0.5,8,20,0.4,8,9,0.889,42,86,0.488,27,54,0.5,15,32,0.469,15,20,0.75
11/20/2017,6,SAS,ATL,W ,96,85,240,40,89,0.449,30,58,0.517,10,31,0.323,6,6,1,37,85,0.435,29,55,0.527,8,30,0.267,3,8,0.375
11/19/2017,4,BRK,GSW,L ,111,118,240,34,95,0.358,18,47,0.383,16,48,0.333,27,39,0.692,46,90,0.511,36,66,0.545,10,24,0.417,16,23,0.696
11/19/2017,10,LAL,DEN,W ,127,109,240,53,100,0.53,41,68,0.603,12,32,0.375,9,16,0.563,36,84,0.429,23,53,0.434,13,31,0.419,24,35,0.686
11/19/2017,6,MIA,IND,L ,95,120,240,35,83,0.422,22,46,0.478,13,37,0.351,12,14,0.857,51,85,0.6,40,62,0.645,11,23,0.478,7,8,0.875
11/19/2017,7,MIN,DET,L ,97,100,240,40,78,0.513,35,56,0.625,5,22,0.227,12,18,0.667,39,83,0.47,31,58,0.534,8,25,0.32,14,20,0.7
11/19/2017,12,PHO,CHI,W ,113,105,240,45,89,0.506,38,62,0.613,7,27,0.259,16,22,0.727,42,101,0.416,30,65,0.462,12,36,0.333,9,14,0.643
11/19/2017,17,TOR,WAS,W ,100,91,240,40,90,0.444,30,51,0.588,10,39,0.256,10,14,0.714,34,81,0.42,23,62,0.371,11,19,0.579,12,21,0.571
11/18/2017,12,ATL,BOS,L ,99,110,240,37,78,0.474,28,54,0.519,9,24,0.375,16,20,0.8,39,82,0.476,23,48,0.479,16,34,0.471,16,20,0.8
11/18/2017,12,CHO,LAC,W ,102,87,240,34,87,0.391,23,61,0.377,11,26,0.423,23,29,0.793,33,83,0.398,25,54,0.463,8,29,0.276,13,19,0.684
11/18/2017,9,DAL,MIL,W ,111,79,240,38,79,0.481,19,41,0.463,19,38,0.5,16,19,0.842,28,74,0.378,22,49,0.449,6,25,0.24,17,31,0.548
11/18/2017,2,MEM,HOU,L ,83,105,240,31,86,0.36,24,59,0.407,7,27,0.259,14,19,0.737,35,78,0.449,17,35,0.486,18,43,0.419,17,21,0.81
11/18/2017,0,ORL,UTA,L ,85,125,240,31,81,0.383,23,52,0.442,8,29,0.276,15,23,0.652,47,98,0.48,33,64,0.516,14,34,0.412,17,18,0.944
11/18/2017,5,PHI,GSW,L ,116,124,240,47,97,0.485,37,68,0.544,10,29,0.345,12,16,0.75,50,91,0.549,43,68,0.632,7,23,0.304,17,20,0.85
11/18/2017,8,POR,SAC,W ,102,90,240,38,70,0.543,28,49,0.571,10,21,0.476,16,21,0.762,34,89,0.382,26,72,0.361,8,17,0.471,14,18,0.778
11/17/2017,5,BRK,UTA,W ,118,107,240,43,84,0.512,26,47,0.553,17,37,0.459,15,20,0.75,39,79,0.494,27,53,0.509,12,26,0.462,17,24,0.708
11/17/2017,14,CHI,CHO,W ,123,120,240,47,91,0.516,30,57,0.526,17,34,0.5,12,13,0.923,42,81,0.519,32,60,0.533,10,21,0.476,26,34,0.765
11/17/2017,1,CLE,LAC,W ,118,113,265,42,90,0.467,31,57,0.544,11,33,0.333,23,29,0.793,46,103,0.447,36,68,0.529,10,35,0.286,11,14,0.786
11/17/2017,5,DAL,MIN,L ,87,111,240,32,86,0.372,24,48,0.5,8,38,0.211,15,17,0.882,39,84,0.464,26,54,0.481,13,30,0.433,20,23,0.87
11/17/2017,0,DEN,NOP,W ,146,114,240,56,89,0.629,38,54,0.704,18,35,0.514,16,21,0.762,48,91,0.527,36,58,0.621,12,33,0.364,6,10,0.6
11/17/2017,5,IND,DET,W ,107,100,240,39,89,0.438,24,61,0.393,15,28,0.536,14,21,0.667,39,93,0.419,25,60,0.417,14,33,0.424,8,10,0.8
11/17/2017,9,LAL,PHO,L ,113,122,240,45,91,0.495,38,66,0.576,7,25,0.28,16,24,0.667,48,103,0.466,35,71,0.493,13,32,0.406,13,19,0.684
11/17/2017,12,SAC,POR,W ,86,82,240,36,85,0.424,32,71,0.451,4,14,0.286,10,15,0.667,30,81,0.37,23,56,0.411,7,25,0.28,15,16,0.938
11/17/2017,2,SAS,OKC,W ,104,101,240,34,77,0.442,20,42,0.476,14,35,0.4,22,28,0.786,39,89,0.438,30,66,0.455,9,23,0.391,14,21,0.667
11/17/2017,4,TOR,NYK,W ,107,84,240,44,78,0.564,35,52,0.673,9,26,0.346,10,11,0.909,30,91,0.33,21,68,0.309,9,23,0.391,15,17,0.882
11/17/2017,1,WAS,MIA,L ,88,91,240,32,84,0.381,22,49,0.449,10,35,0.286,14,16,0.875,34,83,0.41,24,48,0.5,10,35,0.286,13,18,0.722
11/16/2017,10,BOS,GSW,W ,92,88,240,26,79,0.329,19,47,0.404,7,32,0.219,33,38,0.868,33,82,0.402,23,50,0.46,10,32,0.313,12,19,0.632
11/16/2017,1,PHO,HOU,L ,116,142,240,47,104,0.452,37,74,0.5,10,30,0.333,12,21,0.571,43,90,0.478,22,46,0.478,21,44,0.477,35,38,0.921
11/15/2017,0,ATL,SAC,W ,126,80,240,50,79,0.633,34,47,0.723,16,32,0.5,10,16,0.625,31,88,0.352,25,60,0.417,6,28,0.214,12,20,0.6
11/15/2017,15,CHO,CLE,L ,107,115,240,41,86,0.477,35,60,0.583,6,26,0.231,19,28,0.679,42,95,0.442,29,57,0.509,13,38,0.342,18,20,0.9
11/15/2017,6,LAL,PHI,L ,109,115,240,42,109,0.385,39,82,0.476,3,27,0.111,22,27,0.815,42,86,0.488,35,54,0.648,7,32,0.219,24,30,0.8
11/15/2017,0,MEM,IND,L ,113,116,240,44,86,0.512,36,54,0.667,8,32,0.25,17,22,0.773,43,85,0.506,31,61,0.508,12,24,0.5,18,20,0.9
11/15/2017,6,MIA,WAS,L ,93,102,240,32,78,0.41,19,48,0.396,13,30,0.433,16,19,0.842,32,78,0.41,23,59,0.39,9,19,0.474,29,31,0.935
11/15/2017,5,MIL,DET,W ,99,95,240,38,78,0.487,30,56,0.536,8,22,0.364,15,20,0.75,30,85,0.353,15,48,0.313,15,37,0.405,20,23,0.87
11/15/2017,8,MIN,SAS,W ,98,86,240,39,87,0.448,30,69,0.435,9,18,0.5,11,16,0.688,33,79,0.418,26,55,0.473,7,24,0.292,13,15,0.867
11/15/2017,8,NOP,TOR,L ,116,125,240,46,91,0.505,36,64,0.563,10,27,0.37,14,14,1,45,76,0.592,29,42,0.69,16,34,0.471,19,20,0.95
11/15/2017,5,NYK,UTA,W ,106,101,240,38,81,0.469,29,60,0.483,9,21,0.429,21,25,0.84,34,79,0.43,17,44,0.386,17,35,0.486,16,17,0.941
11/15/2017,0,OKC,CHI,W ,92,79,240,26,72,0.361,18,42,0.429,8,30,0.267,32,37,0.865,26,75,0.347,15,46,0.326,11,29,0.379,16,20,0.8
11/15/2017,5,POR,ORL,W ,99,94,240,38,87,0.437,24,60,0.4,14,27,0.519,9,13,0.692,37,79,0.468,26,50,0.52,11,29,0.379,9,9,1
11/14/2017,7,BRK,BOS,L ,102,109,240,39,88,0.443,25,53,0.472,14,35,0.4,10,16,0.625,39,86,0.453,30,59,0.508,9,27,0.333,22,27,0.815
11/14/2017,13,DAL,SAS,L ,91,97,240,33,81,0.407,23,47,0.489,10,34,0.294,15,18,0.833,35,79,0.443,29,53,0.547,6,26,0.231,21,27,0.778
11/14/2017,3,HOU,TOR,L ,113,129,240,33,79,0.418,21,40,0.525,12,39,0.308,35,41,0.854,41,78,0.526,27,48,0.563,14,30,0.467,33,42,0.786
11/13/2017,8,GSW,ORL,W ,110,100,240,44,88,0.5,36,65,0.554,8,23,0.348,14,16,0.875,37,88,0.42,27,56,0.482,10,32,0.313,16,18,0.889
11/13/2017,5,LAC,PHI,L ,105,109,240,36,82,0.439,24,50,0.48,12,32,0.375,21,32,0.656,38,77,0.494,31,45,0.689,7,32,0.219,26,35,0.743
11/13/2017,10,MIL,MEM,W ,110,103,240,40,82,0.488,28,60,0.467,12,22,0.545,18,25,0.72,37,76,0.487,26,50,0.52,11,26,0.423,18,21,0.857
11/13/2017,8,NOP,ATL,W ,106,105,240,41,75,0.547,28,42,0.667,13,33,0.394,11,17,0.647,40,87,0.46,23,51,0.451,17,36,0.472,8,9,0.889
11/13/2017,9,NYK,CLE,L ,101,104,240,38,88,0.432,30,63,0.476,8,25,0.32,17,22,0.773,35,88,0.398,19,43,0.442,16,45,0.356,18,22,0.818
11/13/2017,11,PHO,LAL,L ,93,100,240,37,95,0.389,30,69,0.435,7,26,0.269,12,20,0.6,39,92,0.424,25,59,0.424,14,33,0.424,8,13,0.615
11/13/2017,1,POR,DEN,W ,99,82,240,38,73,0.521,31,52,0.596,7,21,0.333,16,18,0.889,30,84,0.357,21,52,0.404,9,32,0.281,13,15,0.867
11/13/2017,1,UTA,MIN,L ,98,109,240,37,84,0.44,23,44,0.523,14,40,0.35,10,11,0.909,37,71,0.521,27,51,0.529,10,20,0.5,25,29,0.862
11/13/2017,3,WAS,SAC,W ,110,92,240,44,86,0.512,33,52,0.635,11,34,0.324,11,12,0.917,34,84,0.405,22,61,0.361,12,23,0.522,12,18,0.667
11/12/2017,15,BOS,TOR,W ,95,94,240,35,87,0.402,25,61,0.41,10,26,0.385,15,19,0.789,32,69,0.464,22,45,0.489,10,24,0.417,20,23,0.87
11/12/2017,7,DET,MIA,W ,112,103,240,42,87,0.483,28,59,0.475,14,28,0.5,14,20,0.7,39,90,0.433,26,53,0.491,13,37,0.351,12,16,0.75
11/12/2017,0,IND,HOU,L ,95,118,240,37,83,0.446,29,61,0.475,8,22,0.364,13,21,0.619,43,90,0.478,26,43,0.605,17,47,0.362,15,18,0.833
11/12/2017,3,OKC,DAL,W ,112,99,240,36,72,0.5,21,40,0.525,15,32,0.469,25,33,0.758,37,87,0.425,26,50,0.52,11,37,0.297,14,18,0.778
11/11/2017,13,DAL,CLE,L ,104,111,240,39,92,0.424,29,58,0.5,10,34,0.294,16,21,0.762,35,81,0.432,23,50,0.46,12,31,0.387,29,35,0.829
11/11/2017,1,DEN,ORL,W ,125,107,240,46,87,0.529,34,58,0.586,12,29,0.414,21,27,0.778,41,87,0.471,30,56,0.536,11,31,0.355,14,20,0.7
11/11/2017,18,GSW,PHI,W ,135,114,240,48,82,0.585,34,55,0.618,14,27,0.519,25,26,0.962,44,94,0.468,32,66,0.485,12,28,0.429,14,20,0.7
11/11/2017,0,HOU,MEM,W ,111,96,240,37,83,0.446,21,38,0.553,16,45,0.356,21,28,0.75,38,79,0.481,32,59,0.542,6,20,0.3,14,18,0.778
11/11/2017,10,MIL,LAL,W ,98,90,240,35,85,0.412,29,62,0.468,6,23,0.261,22,26,0.846,31,74,0.419,25,52,0.481,6,22,0.273,22,37,0.595
11/11/2017,6,NOP,LAC,W ,111,103,240,43,80,0.538,37,64,0.578,6,16,0.375,19,24,0.792,35,86,0.407,25,60,0.417,10,26,0.385,23,27,0.852
11/11/2017,1,NYK,SAC,W ,118,91,240,47,90,0.522,35,63,0.556,12,27,0.444,12,15,0.8,30,80,0.375,23,58,0.397,7,22,0.318,24,30,0.8
11/11/2017,12,PHO,MIN,W ,118,110,240,46,86,0.535,36,60,0.6,10,26,0.385,16,24,0.667,39,96,0.406,35,76,0.461,4,20,0.2,28,35,0.8
11/11/2017,0,SAS,CHI,W ,133,94,240,51,85,0.6,33,58,0.569,18,27,0.667,13,16,0.813,40,86,0.465,34,63,0.54,6,23,0.261,8,13,0.615
11/11/2017,4,UTA,BRK,W ,114,106,240,41,85,0.482,30,56,0.536,11,29,0.379,21,25,0.84,35,76,0.461,28,53,0.528,7,23,0.304,29,39,0.744
11/11/2017,10,WAS,ATL,W ,113,94,240,42,78,0.538,35,54,0.648,7,24,0.292,22,28,0.786,34,83,0.41,20,50,0.4,14,33,0.424,12,17,0.706
11/10/2017,1,BOS,CHO,W ,90,87,240,30,84,0.357,21,53,0.396,9,31,0.29,21,25,0.84,31,80,0.388,25,58,0.431,6,22,0.273,19,33,0.576
11/10/2017,0,CHI,IND,L ,87,105,240,37,93,0.398,30,66,0.455,7,27,0.259,6,9,0.667,43,84,0.512,31,55,0.564,12,29,0.414,7,12,0.583
11/10/2017,4,DET,ATL,W ,111,104,240,39,89,0.438,27,59,0.458,12,30,0.4,21,27,0.778,44,89,0.494,36,65,0.554,8,24,0.333,8,11,0.727
11/10/2017,9,OKC,LAC,W ,120,111,240,40,78,0.513,29,52,0.558,11,26,0.423,29,40,0.725,39,84,0.464,27,54,0.5,12,30,0.4,21,30,0.7
11/10/2017,8,PHO,ORL,L ,112,128,240,44,94,0.468,39,70,0.557,5,24,0.208,19,25,0.76,43,82,0.524,30,54,0.556,13,28,0.464,29,43,0.674
11/10/2017,15,POR,BRK,L ,97,101,240,40,95,0.421,32,72,0.444,8,23,0.348,9,11,0.818,39,91,0.429,27,53,0.509,12,38,0.316,11,19,0.579
11/10/2017,7,SAS,MIL,L ,87,94,240,34,80,0.425,25,51,0.49,9,29,0.31,10,11,0.909,41,89,0.461,36,71,0.507,5,18,0.278,7,14,0.5
11/10/2017,9,UTA,MIA,L ,74,84,240,25,74,0.338,20,53,0.377,5,21,0.238,19,22,0.864,30,77,0.39,20,52,0.385,10,25,0.4,14,18,0.778
11/9/2017,11,DEN,OKC,W ,102,94,240,38,82,0.463,29,55,0.527,9,27,0.333,17,22,0.773,38,90,0.422,27,60,0.45,11,30,0.367,7,14,0.5
11/9/2017,6,HOU,CLE,W ,117,113,240,36,77,0.468,20,31,0.645,16,46,0.348,29,36,0.806,45,81,0.556,33,54,0.611,12,27,0.444,11,14,0.786
11/9/2017,21,SAC,PHI,W ,109,108,240,40,93,0.43,28,66,0.424,12,27,0.444,17,28,0.607,37,87,0.425,22,50,0.44,15,37,0.405,19,27,0.704
11/9/2017,22,TOR,NOP,W ,122,118,240,45,98,0.459,29,56,0.518,16,42,0.381,16,23,0.696,44,82,0.537,31,51,0.608,13,31,0.419,17,25,0.68
11/9/2017,4,WAS,LAL,W ,111,95,240,43,83,0.518,36,62,0.581,7,21,0.333,18,20,0.9,31,86,0.36,28,63,0.444,3,23,0.13,30,41,0.732
11/8/2017,1,BOS,LAL,W ,107,96,240,38,98,0.388,31,69,0.449,7,29,0.241,24,31,0.774,37,85,0.435,32,61,0.525,5,24,0.208,17,23,0.739
11/8/2017,7,DET,IND,W ,114,97,240,43,83,0.518,31,56,0.554,12,27,0.444,16,25,0.64,38,88,0.432,31,64,0.484,7,24,0.292,14,18,0.778
11/8/2017,8,GSW,MIN,W ,125,101,240,48,85,0.565,33,49,0.673,15,36,0.417,14,18,0.778,38,92,0.413,33,68,0.485,5,24,0.208,20,27,0.741
11/8/2017,5,ORL,NYK,W ,112,99,240,43,80,0.538,30,52,0.577,13,28,0.464,13,22,0.591,42,80,0.525,37,68,0.544,5,12,0.417,10,13,0.769
11/8/2017,0,PHO,MIA,L ,115,126,240,40,88,0.455,28,59,0.475,12,29,0.414,23,30,0.767,43,81,0.531,31,51,0.608,12,30,0.4,28,35,0.8
11/7/2017,5,CLE,MIL,W ,124,119,240,41,82,0.5,32,64,0.5,9,18,0.5,33,38,0.868,47,83,0.566,34,53,0.642,13,30,0.433,12,16,0.75
11/7/2017,1,DEN,BRK,W ,112,104,240,44,93,0.473,35,59,0.593,9,34,0.265,15,20,0.75,38,89,0.427,27,54,0.5,11,35,0.314,17,22,0.773
11/7/2017,14,IND,NOP,L ,112,117,240,44,93,0.473,35,69,0.507,9,24,0.375,15,18,0.833,44,87,0.506,30,52,0.577,14,35,0.4,15,22,0.682
11/7/2017,5,NYK,CHO,W ,118,113,240,45,75,0.6,33,50,0.66,12,25,0.48,16,21,0.762,42,91,0.462,27,54,0.5,15,37,0.405,14,17,0.824
11/7/2017,13,POR,MEM,L ,97,98,240,36,81,0.444,30,62,0.484,6,19,0.316,19,20,0.95,35,73,0.479,28,54,0.519,7,19,0.368,21,25,0.84
11/7/2017,9,SAC,OKC,W ,94,86,240,37,79,0.468,28,55,0.509,9,24,0.375,11,12,0.917,29,86,0.337,19,49,0.388,10,37,0.27,18,23,0.783
11/7/2017,12,SAS,LAC,W ,120,107,240,45,84,0.536,30,56,0.536,15,28,0.536,15,19,0.789,42,82,0.512,31,52,0.596,11,30,0.367,12,17,0.706
11/7/2017,2,TOR,CHI,W ,119,114,240,44,81,0.543,31,56,0.554,13,25,0.52,18,24,0.75,40,80,0.5,29,51,0.569,11,29,0.379,23,28,0.821
11/7/2017,3,UTA,PHI,L ,97,104,240,30,99,0.303,21,60,0.35,9,39,0.231,28,35,0.8,34,81,0.42,22,54,0.407,12,27,0.444,24,30,0.8
11/7/2017,0,WAS,DAL,L ,99,113,240,32,75,0.427,22,50,0.44,10,25,0.4,25,32,0.781,43,91,0.473,32,61,0.525,11,30,0.367,16,20,0.8
11/6/2017,25,ATL,BOS,L ,107,110,240,39,81,0.481,26,55,0.473,13,26,0.5,16,20,0.8,39,81,0.481,25,45,0.556,14,36,0.389,18,22,0.818
11/6/2017,10,GSW,MIA,W ,97,80,240,32,87,0.368,21,55,0.382,11,32,0.344,22,24,0.917,30,83,0.361,22,57,0.386,8,26,0.308,12,17,0.706
11/6/2017,4,PHO,BRK,L ,92,98,240,30,86,0.349,24,61,0.393,6,25,0.24,26,35,0.743,35,87,0.402,27,55,0.491,8,32,0.25,20,29,0.69
11/5/2017,1,CLE,ATL,L ,115,117,240,42,96,0.438,32,60,0.533,10,36,0.278,21,23,0.913,41,86,0.477,30,61,0.492,11,25,0.44,24,34,0.706
11/5/2017,1,HOU,UTA,W ,137,110,240,48,81,0.593,25,42,0.595,23,39,0.59,18,21,0.857,38,88,0.432,25,54,0.463,13,34,0.382,21,24,0.875
11/5/2017,5,LAC,MIA,L ,101,104,240,34,87,0.391,25,56,0.446,9,31,0.29,24,30,0.8,37,84,0.44,23,48,0.479,14,36,0.389,16,19,0.842
11/5/2017,10,LAL,MEM,W ,107,102,240,40,85,0.471,31,58,0.534,9,27,0.333,18,23,0.783,40,87,0.46,29,50,0.58,11,37,0.297,11,14,0.786
11/5/2017,10,MIN,CHO,W ,112,94,240,38,83,0.458,28,59,0.475,10,24,0.417,26,30,0.867,37,89,0.416,28,61,0.459,9,28,0.321,11,21,0.524
11/5/2017,8,NYK,IND,W ,108,101,240,44,88,0.5,38,65,0.585,6,23,0.261,14,19,0.737,37,79,0.468,25,54,0.463,12,25,0.48,15,17,0.882
11/5/2017,8,ORL,BOS,L ,88,104,240,33,91,0.363,27,62,0.435,6,29,0.207,16,18,0.889,39,89,0.438,28,56,0.5,11,33,0.333,15,20,0.75
11/5/2017,2,POR,OKC,W ,103,99,240,37,74,0.5,30,54,0.556,7,20,0.35,22,28,0.786,40,89,0.449,29,56,0.518,11,33,0.333,8,15,0.533
11/5/2017,10,SAS,PHO,W ,112,95,240,44,88,0.5,33,66,0.5,11,22,0.5,13,18,0.722,37,81,0.457,29,58,0.5,8,23,0.348,13,22,0.591
11/5/2017,0,TOR,WAS,L ,96,107,240,37,80,0.463,32,56,0.571,5,24,0.208,17,27,0.63,40,85,0.471,29,62,0.468,11,23,0.478,16,23,0.696
11/4/2017,11,CHI,NOP,L ,90,96,265,35,99,0.354,24,57,0.421,11,42,0.262,9,12,0.75,35,87,0.402,26,56,0.464,9,31,0.29,17,22,0.773
11/4/2017,8,DEN,GSW,L ,108,127,240,40,87,0.46,34,63,0.54,6,24,0.25,22,27,0.815,50,91,0.549,32,51,0.627,18,40,0.45,9,17,0.529
11/4/2017,4,DET,SAC,W ,108,99,240,40,79,0.506,27,55,0.491,13,24,0.542,15,22,0.682,40,76,0.526,30,55,0.545,10,21,0.476,9,13,0.692
11/4/2017,5,LAC,MEM,L ,104,113,240,38,83,0.458,34,57,0.596,4,26,0.154,24,31,0.774,40,84,0.476,27,53,0.509,13,31,0.419,20,24,0.833
11/4/2017,1,MIN,DAL,W ,112,99,240,43,79,0.544,33,55,0.6,10,24,0.417,16,20,0.8,40,87,0.46,30,60,0.5,10,27,0.37,9,12,0.75
11/3/2017,1,ATL,HOU,L ,104,119,240,39,81,0.481,28,48,0.583,11,33,0.333,15,18,0.833,42,89,0.472,26,42,0.619,16,47,0.34,19,23,0.826
11/3/2017,2,DAL,NOP,L ,94,99,240,34,88,0.386,25,54,0.463,9,34,0.265,17,22,0.773,36,89,0.404,29,60,0.483,7,29,0.241,20,26,0.769
11/3/2017,7,DEN,MIA,W ,95,94,240,36,80,0.45,27,57,0.474,9,23,0.391,14,25,0.56,36,77,0.468,21,40,0.525,15,37,0.405,7,11,0.636
11/3/2017,3,DET,MIL,W ,105,96,240,37,78,0.474,29,52,0.558,8,26,0.308,23,28,0.821,39,83,0.47,29,58,0.5,10,25,0.4,8,9,0.889
11/3/2017,2,LAL,BRK,W ,124,112,240,48,94,0.511,39,73,0.534,9,21,0.429,19,27,0.704,37,91,0.407,28,53,0.528,9,38,0.237,29,38,0.763
11/3/2017,3,NYK,PHO,W ,120,107,240,45,87,0.517,37,61,0.607,8,26,0.308,22,25,0.88,34,97,0.351,25,65,0.385,9,32,0.281,30,37,0.811
11/3/2017,2,OKC,BOS,L ,94,101,240,35,87,0.402,22,52,0.423,13,35,0.371,11,14,0.786,36,84,0.429,23,56,0.411,13,28,0.464,16,24,0.667
11/3/2017,14,ORL,CHI,L ,83,105,240,35,86,0.407,25,51,0.49,10,35,0.286,3,5,0.6,40,85,0.471,26,56,0.464,14,29,0.483,11,12,0.917
11/3/2017,11,PHI,IND,W ,121,110,240,46,92,0.5,28,56,0.5,18,36,0.5,11,14,0.786,45,97,0.464,37,69,0.536,8,28,0.286,12,19,0.632
11/3/2017,7,SAS,CHO,W ,108,101,240,39,83,0.47,30,56,0.536,9,27,0.333,21,26,0.808,33,80,0.413,25,56,0.446,8,24,0.333,27,42,0.643
11/3/2017,14,UTA,TOR,L ,100,109,240,35,80,0.438,27,57,0.474,8,23,0.348,22,24,0.917,38,71,0.535,27,41,0.659,11,30,0.367,22,28,0.786
11/3/2017,6,WAS,CLE,L ,122,130,240,45,84,0.536,34,56,0.607,11,28,0.393,21,31,0.677,46,82,0.561,34,55,0.618,12,27,0.444,26,28,0.929
11/2/2017,10,POR,LAL,W ,113,110,240,40,86,0.465,31,64,0.484,9,22,0.409,24,27,0.889,43,79,0.544,39,61,0.639,4,18,0.222,20,27,0.741
11/2/2017,1,SAS,GSW,L ,92,112,240,34,87,0.391,27,63,0.429,7,24,0.292,17,23,0.739,43,83,0.518,29,55,0.527,14,28,0.5,12,16,0.75
11/1/2017,5,BOS,SAC,W ,113,86,240,40,82,0.488,23,41,0.561,17,41,0.415,16,19,0.842,35,81,0.432,29,61,0.475,6,20,0.3,10,12,0.833
11/1/2017,9,CHO,MIL,W ,126,121,240,45,84,0.536,31,59,0.525,14,25,0.56,22,29,0.759,45,91,0.495,26,55,0.473,19,36,0.528,12,15,0.8
11/1/2017,9,CLE,IND,L ,107,124,240,43,86,0.5,36,55,0.655,7,31,0.226,14,20,0.7,49,90,0.544,33,64,0.516,16,26,0.615,10,13,0.769
11/1/2017,0,DEN,TOR,W ,129,111,240,47,88,0.534,31,56,0.554,16,32,0.5,19,29,0.655,42,85,0.494,31,54,0.574,11,31,0.355,16,25,0.64
11/1/2017,7,LAC,DAL,W ,119,98,240,41,78,0.526,28,50,0.56,13,28,0.464,24,29,0.828,35,89,0.393,23,53,0.434,12,36,0.333,16,20,0.8
11/1/2017,8,MEM,ORL,L ,99,101,240,39,82,0.476,29,52,0.558,10,30,0.333,11,16,0.688,38,75,0.507,25,46,0.543,13,29,0.448,12,14,0.857
11/1/2017,3,MIA,CHI,W ,97,91,240,34,83,0.41,22,52,0.423,12,31,0.387,17,19,0.895,36,89,0.404,29,61,0.475,7,28,0.25,12,19,0.632
11/1/2017,4,NOP,MIN,L ,98,104,240,36,84,0.429,28,53,0.528,8,31,0.258,18,21,0.857,41,83,0.494,35,61,0.574,6,22,0.273,16,24,0.667
11/1/2017,4,NYK,HOU,L ,97,119,240,39,90,0.433,31,64,0.484,8,26,0.308,11,13,0.846,42,88,0.477,23,36,0.639,19,52,0.365,16,21,0.762
11/1/2017,6,PHI,ATL,W ,119,109,240,46,99,0.465,33,64,0.516,13,35,0.371,14,25,0.56,41,94,0.436,33,71,0.465,8,23,0.348,19,27,0.704
11/1/2017,17,UTA,POR,W ,112,103,265,34,90,0.378,21,61,0.344,13,29,0.448,31,36,0.861,37,93,0.398,28,59,0.475,9,34,0.265,20,27,0.741
11/1/2017,7,WAS,PHO,L ,116,122,240,41,92,0.446,31,62,0.5,10,30,0.333,24,30,0.8,41,83,0.494,32,59,0.542,9,24,0.375,31,38,0.816
10/31/2017,8,BRK,PHO,L ,114,122,240,42,102,0.412,33,71,0.465,9,31,0.29,21,30,0.7,45,96,0.469,35,74,0.473,10,22,0.455,22,24,0.917
10/31/2017,0,IND,SAC,W ,101,83,240,36,85,0.424,24,56,0.429,12,29,0.414,17,22,0.773,37,88,0.42,35,74,0.473,2,14,0.143,7,14,0.5
10/31/2017,3,LAL,DET,W ,113,93,240,45,91,0.495,33,65,0.508,12,26,0.462,11,14,0.786,41,94,0.436,31,61,0.508,10,33,0.303,1,3,0.333
10/31/2017,1,MIL,OKC,L ,91,110,240,32,77,0.416,23,46,0.5,9,31,0.29,18,22,0.818,40,81,0.494,28,53,0.528,12,28,0.429,18,21,0.857
10/30/2017,3,BOS,SAS,W ,108,94,240,42,88,0.477,31,57,0.544,11,31,0.355,13,16,0.813,36,87,0.414,24,61,0.393,12,26,0.462,10,20,0.5
10/30/2017,0,HOU,PHI,L ,107,115,240,33,83,0.398,20,36,0.556,13,47,0.277,28,38,0.737,44,80,0.55,34,56,0.607,10,24,0.417,17,24,0.708
10/30/2017,3,LAC,GSW,L ,113,141,240,39,86,0.453,29,61,0.475,10,25,0.4,25,30,0.833,52,89,0.584,38,60,0.633,14,29,0.483,23,30,0.767
10/30/2017,10,MEM,CHO,L ,99,104,240,32,93,0.344,24,58,0.414,8,35,0.229,27,33,0.818,37,89,0.416,30,72,0.417,7,17,0.412,23,29,0.793
10/30/2017,9,MIA,MIN,L ,122,125,265,49,93,0.527,42,66,0.636,7,27,0.259,17,25,0.68,41,91,0.451,30,68,0.441,11,23,0.478,32,35,0.914
10/30/2017,8,NOP,ORL,L ,99,115,240,39,85,0.459,32,57,0.561,7,28,0.25,14,18,0.778,43,85,0.506,27,51,0.529,16,34,0.471,13,18,0.722
10/30/2017,2,NYK,DEN,W ,116,110,240,41,82,0.5,28,50,0.56,13,32,0.406,21,23,0.913,35,85,0.412,17,44,0.386,18,41,0.439,22,31,0.71
10/30/2017,3,POR,TOR,L ,85,99,240,31,80,0.388,23,54,0.426,8,26,0.308,15,19,0.789,39,87,0.448,31,63,0.492,8,24,0.333,13,17,0.765
10/30/2017,2,UTA,DAL,W ,104,89,240,38,81,0.469,22,46,0.478,16,35,0.457,12,15,0.8,34,76,0.447,22,52,0.423,12,24,0.5,9,11,0.818
10/29/2017,0,ATL,MIL,L ,106,117,240,36,77,0.468,23,48,0.479,13,29,0.448,21,26,0.808,44,81,0.543,31,55,0.564,13,26,0.5,16,21,0.762
10/29/2017,4,BRK,DEN,L ,111,124,240,39,96,0.406,27,65,0.415,12,31,0.387,21,31,0.677,47,94,0.5,36,74,0.486,11,20,0.55,19,22,0.864
10/29/2017,5,CHO,ORL,W ,120,113,240,53,97,0.546,47,79,0.595,6,18,0.333,8,17,0.471,41,97,0.423,30,64,0.469,11,33,0.333,20,26,0.769
10/29/2017,3,CLE,NYK,L ,95,114,240,31,81,0.383,21,48,0.438,10,33,0.303,23,27,0.852,42,89,0.472,29,61,0.475,13,28,0.464,17,21,0.81
10/29/2017,3,GSW,DET,L ,107,115,240,44,77,0.571,34,50,0.68,10,27,0.37,9,12,0.75,43,93,0.462,31,66,0.47,12,27,0.444,17,17,1
10/29/2017,7,IND,SAS,W ,97,94,240,36,77,0.468,26,55,0.473,10,22,0.455,15,20,0.75,36,90,0.4,27,62,0.435,9,28,0.321,13,18,0.722
10/29/2017,0,SAC,WAS,L ,83,110,240,32,82,0.39,26,60,0.433,6,22,0.273,13,16,0.813,40,85,0.471,23,51,0.451,17,34,0.5,13,20,0.65
10/28/2017,0,CHI,OKC,L ,69,101,240,22,78,0.282,12,41,0.293,10,37,0.27,15,20,0.75,39,88,0.443,26,54,0.481,13,34,0.382,10,14,0.714
10/28/2017,12,DAL,PHI,L ,110,112,240,38,74,0.514,19,34,0.559,19,40,0.475,15,19,0.789,43,87,0.494,27,52,0.519,16,35,0.457,10,14,0.714
10/28/2017,5,LAC,DET,L ,87,95,240,28,84,0.333,13,46,0.283,15,38,0.395,16,22,0.727,36,88,0.409,27,60,0.45,9,28,0.321,14,21,0.667
10/28/2017,9,MEM,HOU,W ,103,89,240,40,85,0.471,26,52,0.5,14,33,0.424,9,12,0.75,29,77,0.377,15,39,0.385,14,38,0.368,17,21,0.81
10/28/2017,3,MIA,BOS,L ,90,96,240,34,79,0.43,27,48,0.563,7,31,0.226,15,16,0.938,34,81,0.42,28,58,0.483,6,23,0.261,22,26,0.846
10/28/2017,4,NOP,CLE,W ,123,101,240,49,95,0.516,36,62,0.581,13,33,0.394,12,16,0.75,36,78,0.462,24,46,0.522,12,32,0.375,17,23,0.739
10/28/2017,11,POR,PHO,W ,114,107,240,40,91,0.44,29,65,0.446,11,26,0.423,23,28,0.821,37,87,0.425,28,61,0.459,9,26,0.346,24,30,0.8
10/28/2017,0,UTA,LAL,W ,96,81,240,37,79,0.468,24,48,0.5,13,31,0.419,9,13,0.692,31,81,0.383,26,59,0.441,5,22,0.227,14,20,0.7
10/27/2017,21,ATL,DEN,L ,100,105,240,37,89,0.416,23,56,0.411,14,33,0.424,12,12,1,42,91,0.462,38,71,0.535,4,20,0.2,17,23,0.739
10/27/2017,3,CHO,HOU,L ,93,109,240,33,88,0.375,22,59,0.373,11,29,0.379,16,28,0.571,38,85,0.447,16,28,0.571,22,57,0.386,11,13,0.846
10/27/2017,10,GSW,WAS,W ,120,117,240,46,95,0.484,36,57,0.632,10,38,0.263,18,20,0.9,43,97,0.443,28,64,0.438,15,33,0.455,16,22,0.727
10/27/2017,16,LAL,TOR,L ,92,101,240,36,79,0.456,33,56,0.589,3,23,0.13,17,24,0.708,40,93,0.43,33,64,0.516,7,29,0.241,14,20,0.7
10/27/2017,31,MIN,OKC,W ,119,116,240,42,86,0.488,34,64,0.531,8,22,0.364,27,35,0.771,43,86,0.5,35,58,0.603,8,28,0.286,22,25,0.88
10/27/2017,10,NYK,BRK,W ,107,86,240,44,98,0.449,35,71,0.493,9,27,0.333,10,17,0.588,30,75,0.4,19,45,0.422,11,30,0.367,15,21,0.714
10/27/2017,2,ORL,SAS,W ,114,87,240,48,84,0.571,37,61,0.607,11,23,0.478,7,14,0.5,30,89,0.337,26,65,0.4,4,24,0.167,23,27,0.852
10/26/2017,15,CHI,ATL,W ,91,86,240,31,86,0.36,24,54,0.444,7,32,0.219,22,29,0.759,32,81,0.395,21,53,0.396,11,28,0.393,11,13,0.846
10/26/2017,5,MEM,DAL,W ,96,91,240,30,73,0.411,20,39,0.513,10,34,0.294,26,30,0.867,32,94,0.34,22,60,0.367,10,34,0.294,17,20,0.85
10/26/2017,12,MIL,BOS,L ,89,96,240,35,77,0.455,24,52,0.462,11,25,0.44,8,14,0.571,33,78,0.423,22,48,0.458,11,30,0.367,19,22,0.864
10/26/2017,17,POR,LAC,L ,103,104,240,35,89,0.393,21,58,0.362,14,31,0.452,19,22,0.864,36,77,0.468,27,49,0.551,9,28,0.321,23,36,0.639
10/26/2017,8,SAC,NOP,L ,106,114,240,38,81,0.469,31,61,0.508,7,20,0.35,23,25,0.92,42,86,0.488,29,54,0.537,13,32,0.406,17,23,0.739
10/25/2017,19,BRK,CLE,W ,112,107,240,40,93,0.43,23,47,0.489,17,46,0.37,15,21,0.714,39,81,0.481,27,46,0.587,12,35,0.343,17,26,0.654
10/25/2017,2,CHO,DEN,W ,110,93,240,38,81,0.469,25,50,0.5,13,31,0.419,21,26,0.808,38,100,0.38,30,69,0.435,8,31,0.258,9,15,0.6
10/25/2017,2,DAL,MEM,W ,103,94,240,36,74,0.486,25,48,0.521,11,26,0.423,20,29,0.69,33,72,0.458,21,41,0.512,12,31,0.387,16,24,0.667
10/25/2017,1,DET,MIN,W ,122,101,240,48,92,0.522,33,58,0.569,15,34,0.441,11,17,0.647,37,85,0.435,28,60,0.467,9,25,0.36,18,21,0.857
10/25/2017,9,GSW,TOR,W ,117,112,240,43,77,0.558,31,51,0.608,12,26,0.462,19,22,0.864,43,94,0.457,35,60,0.583,8,34,0.235,18,19,0.947
10/25/2017,6,LAL,WAS,W ,102,99,265,41,92,0.446,34,62,0.548,7,30,0.233,13,16,0.813,39,95,0.411,33,69,0.478,6,26,0.231,15,23,0.652
10/25/2017,4,MIA,SAS,L ,100,117,240,37,80,0.463,28,54,0.519,9,26,0.346,17,18,0.944,42,76,0.553,32,59,0.542,10,17,0.588,23,30,0.767
10/25/2017,7,OKC,IND,W ,114,96,240,43,89,0.483,33,62,0.532,10,27,0.37,18,26,0.692,28,83,0.337,18,54,0.333,10,29,0.345,30,35,0.857
10/25/2017,3,PHI,HOU,L ,104,105,240,43,97,0.443,31,61,0.508,12,36,0.333,6,10,0.6,36,75,0.48,24,36,0.667,12,39,0.308,21,24,0.875
10/25/2017,0,PHO,UTA,W ,97,88,240,42,96,0.438,36,77,0.468,6,19,0.316,7,9,0.778,32,77,0.416,26,52,0.5,6,25,0.24,18,25,0.72
10/24/2017,5,BOS,NYK,W ,110,89,240,37,75,0.493,23,46,0.5,14,29,0.483,22,27,0.815,36,85,0.424,35,73,0.479,1,12,0.083,16,25,0.64
10/24/2017,3,CLE,CHI,W ,119,112,240,43,83,0.518,27,45,0.6,16,38,0.421,17,22,0.773,42,88,0.477,25,55,0.455,17,33,0.515,11,13,0.846
10/24/2017,9,LAC,UTA,W ,102,84,240,39,83,0.47,29,54,0.537,10,29,0.345,14,21,0.667,34,79,0.43,27,51,0.529,7,28,0.25,9,11,0.818
10/24/2017,10,MIN,IND,L ,107,130,240,42,86,0.488,33,62,0.532,9,24,0.375,14,22,0.636,56,84,0.667,46,62,0.742,10,22,0.455,8,11,0.727
10/24/2017,9,ORL,BRK,W ,125,121,240,41,83,0.494,33,60,0.55,8,23,0.348,35,40,0.875,40,96,0.417,29,61,0.475,11,35,0.314,30,34,0.882
10/24/2017,14,POR,NOP,W ,103,93,240,33,88,0.375,23,59,0.39,10,29,0.345,27,33,0.818,30,76,0.395,21,46,0.457,9,30,0.3,24,32,0.75
10/23/2017,0,DAL,GSW,L ,103,133,240,38,96,0.396,29,67,0.433,9,29,0.31,18,30,0.6,48,86,0.558,33,47,0.702,15,39,0.385,22,26,0.846
10/23/2017,13,DEN,WAS,L ,104,109,240,39,80,0.488,31,57,0.544,8,23,0.348,18,23,0.783,37,84,0.44,28,54,0.519,9,30,0.3,26,28,0.929
10/23/2017,0,DET,PHI,L ,86,97,240,33,85,0.388,27,55,0.491,6,30,0.2,14,19,0.737,35,75,0.467,26,51,0.51,9,24,0.375,18,24,0.75
10/23/2017,2,HOU,MEM,L ,90,98,240,32,77,0.416,23,39,0.59,9,38,0.237,17,23,0.739,29,68,0.426,23,49,0.469,6,19,0.316,34,37,0.919
10/23/2017,1,MIA,ATL,W ,104,93,240,39,85,0.459,25,48,0.521,14,37,0.378,12,18,0.667,36,76,0.474,29,59,0.492,7,17,0.412,14,18,0.778
10/23/2017,14,MIL,CHO,W ,103,94,240,40,85,0.471,31,59,0.525,9,26,0.346,14,16,0.875,33,78,0.423,26,52,0.5,7,26,0.269,21,36,0.583
10/23/2017,1,PHO,SAC,W ,117,115,240,42,77,0.545,32,47,0.681,10,30,0.333,23,27,0.852,43,99,0.434,34,77,0.442,9,22,0.409,20,29,0.69
10/23/2017,22,SAS,TOR,W ,101,97,240,40,90,0.444,35,70,0.5,5,20,0.25,16,23,0.696,34,80,0.425,24,43,0.558,10,37,0.27,19,24,0.792
10/22/2017,7,BRK,ATL,W ,116,104,240,41,87,0.471,30,60,0.5,11,27,0.407,23,34,0.676,32,94,0.34,25,67,0.373,7,27,0.259,33,36,0.917
10/22/2017,2,LAL,NOP,L ,112,119,240,44,90,0.489,35,63,0.556,9,27,0.333,15,20,0.75,47,83,0.566,37,51,0.725,10,32,0.313,15,21,0.714
10/22/2017,9,OKC,MIN,L ,113,115,240,46,96,0.479,35,65,0.538,11,31,0.355,10,16,0.625,43,86,0.5,33,61,0.541,10,25,0.4,19,23,0.826
10/21/2017,13,CHI,SAS,L ,77,87,240,31,82,0.378,23,54,0.426,8,28,0.286,7,9,0.778,38,93,0.409,37,81,0.457,1,12,0.083,10,16,0.625
10/21/2017,0,CLE,ORL,L ,93,114,240,33,86,0.384,26,61,0.426,7,25,0.28,20,27,0.741,40,90,0.444,23,55,0.418,17,35,0.486,17,20,0.85
10/21/2017,3,DEN,SAC,W ,96,79,240,37,85,0.435,27,55,0.491,10,30,0.333,12,20,0.6,31,85,0.365,23,63,0.365,8,22,0.364,9,13,0.692
10/21/2017,3,HOU,DAL,W ,107,91,240,39,82,0.476,28,35,0.8,11,47,0.234,18,22,0.818,31,84,0.369,18,53,0.34,13,31,0.419,16,21,0.762
10/21/2017,3,LAC,PHO,W ,130,88,240,48,88,0.545,36,62,0.581,12,26,0.462,22,30,0.733,27,71,0.38,21,47,0.447,6,24,0.25,28,38,0.737
10/21/2017,8,MEM,GSW,W ,111,101,240,36,77,0.468,26,50,0.52,10,27,0.37,29,37,0.784,33,84,0.393,21,46,0.457,12,38,0.316,23,27,0.852
10/21/2017,5,MIA,IND,W ,112,108,240,45,87,0.517,31,53,0.585,14,34,0.412,8,14,0.571,43,96,0.448,36,77,0.468,7,19,0.368,15,21,0.714
10/21/2017,10,MIL,POR,W ,113,110,240,42,80,0.525,35,62,0.565,7,18,0.389,22,30,0.733,34,81,0.42,23,53,0.434,11,28,0.393,31,35,0.886
10/21/2017,14,NYK,DET,L ,107,111,240,37,81,0.457,29,51,0.569,8,30,0.267,25,31,0.806,44,91,0.484,35,61,0.574,9,30,0.3,14,15,0.933
10/21/2017,1,TOR,PHI,W ,128,94,240,42,89,0.472,29,45,0.644,13,44,0.295,31,37,0.838,32,82,0.39,24,58,0.414,8,24,0.333,22,36,0.611
10/21/2017,3,UTA,OKC,W ,96,87,240,38,77,0.494,29,48,0.604,9,29,0.31,11,14,0.786,32,78,0.41,21,45,0.467,11,33,0.333,12,19,0.632
10/20/2017,11,BRK,ORL,W ,126,121,240,46,92,0.5,37,65,0.569,9,27,0.333,25,35,0.714,45,89,0.506,27,56,0.482,18,33,0.545,13,15,0.867
10/20/2017,5,CHO,ATL,W ,109,91,240,37,86,0.43,26,50,0.52,11,36,0.306,24,30,0.8,36,95,0.379,29,65,0.446,7,30,0.233,12,14,0.857
10/20/2017,8,DAL,SAC,L ,88,93,240,31,75,0.413,20,42,0.476,11,33,0.333,15,21,0.714,37,87,0.425,27,64,0.422,10,23,0.435,9,13,0.692
10/20/2017,4,IND,POR,L ,96,114,240,35,78,0.449,31,60,0.517,4,18,0.222,22,33,0.667,46,95,0.484,37,76,0.487,9,19,0.474,13,17,0.765
10/20/2017,11,MIL,CLE,L ,97,116,240,38,82,0.463,27,47,0.574,11,35,0.314,10,12,0.833,44,81,0.543,33,55,0.6,11,26,0.423,17,17,1
10/20/2017,10,MIN,UTA,W ,100,97,240,36,81,0.444,29,59,0.492,7,22,0.318,21,26,0.808,37,77,0.481,28,55,0.509,9,22,0.409,14,17,0.824
10/20/2017,16,NOP,GSW,L ,120,128,240,45,98,0.459,29,62,0.468,16,36,0.444,14,22,0.636,47,92,0.511,29,51,0.569,18,41,0.439,16,20,0.8
10/20/2017,2,PHI,BOS,L ,92,102,240,35,92,0.38,25,60,0.417,10,32,0.313,12,16,0.75,35,84,0.417,25,55,0.455,10,29,0.345,22,32,0.688
10/20/2017,10,PHO,LAL,L ,130,132,240,45,92,0.489,31,63,0.492,14,29,0.483,26,38,0.684,48,93,0.516,36,67,0.537,12,26,0.462,24,33,0.727
10/20/2017,12,WAS,DET,W ,115,111,240,40,75,0.533,34,58,0.586,6,17,0.353,29,35,0.829,43,87,0.494,33,64,0.516,10,23,0.435,15,20,0.75
10/19/2017,2,LAL,LAC,L ,92,108,240,37,91,0.407,33,75,0.44,4,16,0.25,14,23,0.609,42,107,0.393,30,74,0.405,12,33,0.364,12,13,0.923
10/19/2017,6,OKC,NYK,W ,105,84,240,39,90,0.433,28,52,0.538,11,38,0.289,16,22,0.727,32,79,0.405,25,55,0.455,7,24,0.292,13,19,0.684
10/19/2017,1,TOR,CHI,W ,117,100,240,39,83,0.47,26,54,0.481,13,29,0.448,26,28,0.929,37,89,0.416,27,57,0.474,10,32,0.313,16,18,0.889
10/18/2017,14,BOS,MIL,L ,100,108,240,39,91,0.429,28,63,0.444,11,28,0.393,11,21,0.524,38,76,0.5,31,55,0.564,7,21,0.333,25,30,0.833
10/18/2017,18,DAL,ATL,L ,111,117,240,38,86,0.442,21,41,0.512,17,45,0.378,18,21,0.857,48,94,0.511,39,76,0.513,9,18,0.5,12,15,0.8
10/18/2017,2,DET,CHO,W ,102,90,240,41,96,0.427,32,70,0.457,9,26,0.346,11,12,0.917,29,73,0.397,20,43,0.465,9,30,0.3,23,29,0.793
10/18/2017,10,IND,BRK,W ,140,131,240,53,102,0.52,44,68,0.647,9,34,0.265,25,32,0.781,45,94,0.479,33,64,0.516,12,30,0.4,29,32,0.906
10/18/2017,8,MEM,NOP,W ,103,91,240,39,92,0.424,30,63,0.476,9,29,0.31,16,28,0.571,30,79,0.38,23,54,0.426,7,25,0.28,24,29,0.828
10/18/2017,3,ORL,MIA,W ,116,109,240,43,90,0.478,35,69,0.507,8,21,0.381,22,29,0.759,44,101,0.436,36,71,0.507,8,30,0.267,13,17,0.765
10/18/2017,3,PHO,POR,L ,76,124,240,28,89,0.315,21,62,0.339,7,27,0.259,13,18,0.722,44,90,0.489,30,66,0.455,14,24,0.583,22,28,0.786
10/18/2017,8,SAC,HOU,L ,100,105,240,42,88,0.477,34,65,0.523,8,23,0.348,8,10,0.8,33,83,0.398,21,38,0.553,12,45,0.267,27,29,0.931
10/18/2017,8,SAS,MIN,W ,107,99,240,41,89,0.461,33,68,0.485,8,21,0.381,17,19,0.895,37,85,0.435,29,66,0.439,8,19,0.421,17,23,0.739
10/18/2017,4,UTA,DEN,W ,106,96,240,41,81,0.506,32,57,0.561,9,24,0.375,15,16,0.938,36,77,0.468,23,50,0.46,13,27,0.481,11,12,0.917
10/18/2017,12,WAS,PHI,W ,120,115,240,42,97,0.433,36,75,0.48,6,22,0.273,30,38,0.789,43,93,0.462,28,58,0.483,15,35,0.429,14,19,0.737
10/17/2017,11,CLE,BOS,W ,102,99,240,38,83,0.458,33,61,0.541,5,22,0.227,21,25,0.84,36,88,0.409,28,56,0.5,8,32,0.25,19,25,0.76
10/17/2017,2,GSW,HOU,L ,121,122,240,43,80,0.538,27,50,0.54,16,30,0.533,19,21,0.905,47,97,0.485,32,56,0.571,15,41,0.366,13,19,0.684
4/12/2017,9,BOS,MIL,W ,112,94,240,41,91,0.451,29,54,0.537,12,37,0.324,18,26,0.692,37,84,0.44,31,61,0.508,6,23,0.261,14,17,0.824
4/12/2017,0,CHI,BRK,W ,112,73,240,41,95,0.432,27,65,0.415,14,30,0.467,16,21,0.762,28,86,0.326,25,53,0.472,3,33,0.091,14,18,0.778
4/12/2017,6,CLE,TOR,L ,83,98,240,28,76,0.368,18,39,0.462,10,37,0.27,17,24,0.708,40,86,0.465,32,60,0.533,8,26,0.308,10,16,0.625
4/12/2017,2,GSW,LAL,W ,109,94,240,41,90,0.456,29,54,0.537,12,36,0.333,15,22,0.682,41,93,0.441,37,76,0.487,4,17,0.235,8,14,0.571
4/12/2017,4,HOU,MIN,W ,123,118,240,45,97,0.464,26,41,0.634,19,56,0.339,14,22,0.636,48,91,0.527,37,68,0.544,11,23,0.478,11,15,0.733
4/12/2017,4,IND,ATL,W ,104,86,240,39,82,0.476,29,58,0.5,10,24,0.417,16,19,0.842,30,72,0.417,19,43,0.442,11,29,0.379,15,19,0.789
4/12/2017,1,LAC,SAC,W ,115,95,240,43,83,0.518,33,55,0.6,10,28,0.357,19,25,0.76,40,81,0.494,35,70,0.5,5,11,0.455,10,14,0.714
4/12/2017,4,MEM,DAL,L ,93,100,240,33,84,0.393,25,59,0.424,8,25,0.32,19,22,0.864,33,75,0.44,24,41,0.585,9,34,0.265,25,31,0.806
4/12/2017,1,MIA,WAS,W ,110,102,240,46,88,0.523,38,64,0.594,8,24,0.333,10,12,0.833,42,87,0.483,35,61,0.574,7,26,0.269,11,14,0.786
4/12/2017,11,NYK,PHI,W ,114,113,240,41,83,0.494,32,61,0.525,9,22,0.409,23,32,0.719,46,93,0.495,39,70,0.557,7,23,0.304,14,20,0.7
4/12/2017,4,OKC,DEN,L ,105,111,240,43,101,0.426,35,76,0.461,8,25,0.32,11,17,0.647,39,85,0.459,32,60,0.533,7,25,0.28,26,32,0.813
4/12/2017,4,ORL,DET,W ,113,109,240,42,87,0.483,29,62,0.468,13,25,0.52,16,17,0.941,41,106,0.387,30,70,0.429,11,36,0.306,16,28,0.571
4/12/2017,10,POR,NOP,L ,100,103,240,41,85,0.482,28,55,0.509,13,30,0.433,5,13,0.385,40,90,0.444,32,66,0.485,8,24,0.333,15,21,0.714
4/12/2017,8,UTA,SAS,W ,101,97,240,39,77,0.506,29,51,0.569,10,26,0.385,13,20,0.65,39,86,0.453,31,65,0.477,8,21,0.381,11,13,0.846
4/11/2017,2,ATL,CHO,W ,103,76,240,41,79,0.519,34,52,0.654,7,27,0.259,14,18,0.778,29,88,0.33,26,65,0.4,3,23,0.13,15,19,0.789
4/11/2017,3,DAL,DEN,L ,91,109,240,35,88,0.398,23,48,0.479,12,40,0.3,9,11,0.818,41,84,0.488,23,42,0.548,18,42,0.429,9,14,0.643
4/11/2017,4,LAL,NOP,W ,108,96,240,42,88,0.477,34,66,0.515,8,22,0.364,16,23,0.696,37,79,0.468,30,57,0.526,7,22,0.318,15,20,0.75
4/11/2017,18,MIN,OKC,L ,98,100,240,38,86,0.442,33,66,0.5,5,20,0.25,17,25,0.68,37,86,0.43,30,64,0.469,7,22,0.318,19,25,0.76
4/11/2017,0,SAC,PHO,W ,129,104,240,43,83,0.518,34,64,0.531,9,19,0.474,34,43,0.791,41,109,0.376,33,79,0.418,8,30,0.267,14,24,0.583
4/10/2017,0,BOS,BRK,W ,114,105,240,41,91,0.451,27,53,0.509,14,38,0.368,18,21,0.857,31,86,0.36,23,55,0.418,8,31,0.258,35,39,0.897
4/10/2017,1,CHI,ORL,W ,122,75,240,48,89,0.539,36,63,0.571,12,26,0.462,14,16,0.875,29,84,0.345,24,57,0.421,5,27,0.185,12,16,0.75
4/10/2017,3,DET,WAS,L ,101,105,240,43,94,0.457,33,68,0.485,10,26,0.385,5,5,1,42,83,0.506,35,64,0.547,7,19,0.368,14,16,0.875
4/10/2017,12,GSW,UTA,L ,99,105,240,39,80,0.488,30,55,0.545,9,25,0.36,12,17,0.706,41,92,0.446,28,57,0.491,13,35,0.371,10,15,0.667
4/10/2017,9,LAC,HOU,W ,125,96,240,46,91,0.505,36,65,0.554,10,26,0.385,23,28,0.821,33,84,0.393,24,44,0.545,9,40,0.225,21,27,0.778
4/10/2017,17,MIA,CLE,W ,124,121,265,44,95,0.463,32,62,0.516,12,33,0.364,24,34,0.706,44,89,0.494,30,54,0.556,14,35,0.4,19,22,0.864
4/10/2017,7,MIL,CHO,W ,89,79,240,35,78,0.449,19,51,0.373,16,27,0.593,3,5,0.6,33,81,0.407,28,63,0.444,5,18,0.278,8,13,0.615
4/10/2017,0,PHI,IND,L ,111,120,240,35,75,0.467,22,42,0.524,13,33,0.394,28,31,0.903,49,85,0.576,44,69,0.638,5,16,0.313,17,21,0.81
4/10/2017,12,POR,SAS,W ,99,98,240,37,89,0.416,25,62,0.403,12,27,0.444,13,15,0.867,38,83,0.458,30,62,0.484,8,21,0.381,14,20,0.7
4/9/2017,3,ATL,CLE,W ,126,125,265,44,94,0.468,35,63,0.556,9,31,0.29,29,37,0.784,45,98,0.459,26,52,0.5,19,46,0.413,16,20,0.8
4/9/2017,10,DEN,OKC,L ,105,106,240,40,84,0.476,29,50,0.58,11,34,0.324,14,15,0.933,40,96,0.417,34,71,0.479,6,25,0.24,20,22,0.909
4/9/2017,16,LAL,MIN,W ,110,109,240,42,86,0.488,32,59,0.542,10,27,0.37,16,20,0.8,40,80,0.5,37,65,0.569,3,15,0.2,26,31,0.839
4/9/2017,7,MEM,DET,L ,90,103,240,36,75,0.48,27,54,0.5,9,21,0.429,9,13,0.692,39,82,0.476,25,54,0.463,14,28,0.5,11,16,0.688
4/9/2017,13,NYK,TOR,L ,97,110,240,37,82,0.451,28,54,0.519,9,28,0.321,14,15,0.933,40,77,0.519,30,46,0.652,10,31,0.323,20,23,0.87
4/9/2017,3,PHO,DAL,W ,124,111,240,44,80,0.55,36,61,0.59,8,19,0.421,28,32,0.875,41,97,0.423,25,52,0.481,16,45,0.356,13,19,0.684
4/9/2017,3,SAC,HOU,L ,128,135,240,47,94,0.5,38,63,0.603,9,31,0.29,25,30,0.833,45,80,0.563,27,37,0.73,18,43,0.419,27,31,0.871
4/8/2017,6,BRK,CHI,W ,107,106,240,39,92,0.424,29,61,0.475,10,31,0.323,19,24,0.792,40,90,0.444,29,66,0.439,11,24,0.458,15,17,0.882
4/8/2017,7,CHO,BOS,L ,114,121,240,38,84,0.452,29,56,0.518,9,28,0.321,29,32,0.906,45,87,0.517,28,48,0.583,17,39,0.436,14,17,0.824
4/8/2017,4,GSW,NOP,W ,123,101,240,49,96,0.51,39,63,0.619,10,33,0.303,15,16,0.938,42,86,0.488,37,65,0.569,5,21,0.238,12,19,0.632
4/8/2017,13,ORL,IND,L ,112,127,240,41,84,0.488,27,54,0.5,14,30,0.467,16,22,0.727,51,86,0.593,40,64,0.625,11,22,0.5,14,19,0.737
4/8/2017,8,PHI,MIL,L ,82,90,240,27,77,0.351,19,46,0.413,8,31,0.258,20,23,0.87,35,79,0.443,29,52,0.558,6,27,0.222,14,20,0.7
4/8/2017,1,POR,UTA,W ,101,86,240,37,91,0.407,24,61,0.393,13,30,0.433,14,16,0.875,31,78,0.397,25,59,0.424,6,19,0.316,18,24,0.75
4/8/2017,10,SAS,LAC,L ,87,98,240,34,80,0.425,26,58,0.448,8,22,0.364,11,14,0.786,42,84,0.5,36,62,0.581,6,22,0.273,8,14,0.571
4/8/2017,17,WAS,MIA,L ,103,106,240,39,81,0.481,31,59,0.525,8,22,0.364,17,22,0.773,37,80,0.463,30,62,0.484,7,18,0.389,25,36,0.694
4/7/2017,14,CLE,ATL,L ,100,114,240,39,81,0.481,30,45,0.667,9,36,0.25,13,17,0.765,45,89,0.506,29,52,0.558,16,37,0.432,8,8,1
4/7/2017,4,DAL,SAS,L ,89,102,240,38,88,0.432,30,62,0.484,8,26,0.308,5,8,0.625,40,96,0.417,31,68,0.456,9,28,0.321,13,22,0.591
4/7/2017,13,DEN,NOP,W ,122,106,240,43,78,0.551,30,46,0.652,13,32,0.406,23,32,0.719,47,99,0.475,44,76,0.579,3,23,0.13,9,13,0.692
4/7/2017,3,HOU,DET,L ,109,114,240,36,87,0.414,20,36,0.556,16,51,0.314,21,28,0.75,46,108,0.426,37,82,0.451,9,26,0.346,13,16,0.813
4/7/2017,17,LAL,SAC,W ,98,94,240,38,86,0.442,34,62,0.548,4,24,0.167,18,25,0.72,38,75,0.507,30,55,0.545,8,20,0.4,10,13,0.769
4/7/2017,3,MEM,NYK,W ,101,88,240,38,75,0.507,23,48,0.479,15,27,0.556,10,12,0.833,38,88,0.432,32,60,0.533,6,28,0.214,6,13,0.462
4/7/2017,2,PHO,OKC,W ,120,99,240,43,83,0.518,35,65,0.538,8,18,0.444,26,31,0.839,34,92,0.37,27,62,0.435,7,30,0.233,24,33,0.727
4/7/2017,1,TOR,MIA,W ,96,94,240,35,85,0.412,26,65,0.4,9,20,0.45,17,24,0.708,33,83,0.398,25,60,0.417,8,23,0.348,20,29,0.69
4/7/2017,19,UTA,MIN,W ,120,113,240,45,75,0.6,31,50,0.62,14,25,0.56,16,22,0.727,39,79,0.494,32,63,0.508,7,16,0.438,28,28,1
4/6/2017,1,ATL,BOS,W ,123,116,240,44,89,0.494,33,66,0.5,11,23,0.478,24,34,0.706,37,90,0.411,22,47,0.468,15,43,0.349,27,34,0.794
4/6/2017,5,IND,MIL,W ,104,89,240,38,80,0.475,30,55,0.545,8,25,0.32,20,26,0.769,33,71,0.465,22,47,0.468,11,24,0.458,12,14,0.857
4/6/2017,2,NYK,WAS,L ,103,106,240,40,95,0.421,33,75,0.44,7,20,0.35,16,21,0.762,36,74,0.486,22,40,0.55,14,34,0.412,20,28,0.714
4/6/2017,11,ORL,BRK,W ,115,107,240,42,90,0.467,33,65,0.508,9,25,0.36,22,26,0.846,40,87,0.46,29,57,0.509,11,30,0.367,16,22,0.727
4/6/2017,1,PHI,CHI,L ,90,102,240,33,91,0.363,26,58,0.448,7,33,0.212,17,22,0.773,39,91,0.429,31,66,0.47,8,25,0.32,16,17,0.941
4/6/2017,1,POR,MIN,W ,105,98,240,35,81,0.432,21,48,0.438,14,33,0.424,21,26,0.808,38,87,0.437,34,69,0.493,4,18,0.222,18,20,0.9
4/5/2017,2,BOS,CLE,L ,91,114,240,33,81,0.407,26,48,0.542,7,33,0.212,18,29,0.621,43,92,0.467,32,56,0.571,11,36,0.306,17,18,0.944
4/5/2017,10,CHO,MIA,L ,99,112,240,35,78,0.449,27,53,0.509,8,25,0.32,21,24,0.875,40,84,0.476,19,44,0.432,21,40,0.525,11,12,0.917
4/5/2017,1,DET,TOR,L ,102,105,240,42,81,0.519,35,60,0.583,7,21,0.333,11,18,0.611,41,87,0.471,31,57,0.544,10,30,0.333,13,15,0.867
4/5/2017,5,HOU,DEN,W ,110,104,240,37,87,0.425,27,53,0.509,10,34,0.294,26,38,0.684,41,104,0.394,34,66,0.515,7,38,0.184,15,18,0.833
4/5/2017,0,LAC,DAL,W ,112,101,240,38,75,0.507,26,44,0.591,12,31,0.387,24,31,0.774,38,86,0.442,27,55,0.491,11,31,0.355,14,18,0.778
4/5/2017,14,MEM,OKC,L ,100,103,240,37,78,0.474,28,52,0.538,9,26,0.346,17,21,0.81,37,85,0.435,23,54,0.426,14,31,0.452,15,24,0.625
4/5/2017,1,PHO,GSW,L ,111,120,240,43,103,0.417,36,76,0.474,7,27,0.259,18,26,0.692,45,89,0.506,32,59,0.542,13,30,0.433,17,24,0.708
4/5/2017,0,SAS,LAL,L ,95,102,240,39,89,0.438,26,54,0.481,13,35,0.371,4,6,0.667,42,86,0.488,35,72,0.486,7,14,0.5,11,14,0.786
4/4/2017,10,CLE,ORL,W ,122,102,240,44,82,0.537,26,46,0.565,18,36,0.5,16,21,0.762,33,86,0.384,22,53,0.415,11,33,0.333,25,26,0.962
4/4/2017,10,GSW,MIN,W ,121,107,240,44,84,0.524,30,52,0.577,14,32,0.438,19,24,0.792,41,96,0.427,37,77,0.481,4,19,0.211,21,26,0.808
4/4/2017,9,IND,TOR,W ,108,90,240,39,89,0.438,27,64,0.422,12,25,0.48,18,18,1,34,76,0.447,29,53,0.547,5,23,0.217,17,19,0.895
4/4/2017,17,NOP,DEN,L ,131,134,240,51,100,0.51,37,68,0.544,14,32,0.438,15,17,0.882,53,99,0.535,40,69,0.58,13,30,0.433,15,21,0.714
4/4/2017,1,NYK,CHI,W ,100,91,240,42,89,0.472,36,66,0.545,6,23,0.261,10,16,0.625,32,85,0.376,26,58,0.448,6,27,0.222,21,23,0.913
4/4/2017,2,OKC,MIL,W ,110,79,240,40,84,0.476,31,56,0.554,9,28,0.321,21,25,0.84,29,81,0.358,26,63,0.413,3,18,0.167,18,26,0.692
4/4/2017,2,PHI,BRK,L ,118,141,240,43,97,0.443,31,59,0.525,12,38,0.316,20,27,0.741,48,75,0.64,32,44,0.727,16,31,0.516,29,33,0.879
4/4/2017,10,SAC,DAL,W ,98,87,240,36,81,0.444,24,59,0.407,12,22,0.545,14,17,0.824,32,80,0.4,20,37,0.541,12,43,0.279,11,14,0.786
4/4/2017,10,SAS,MEM,W ,95,89,265,35,80,0.438,24,59,0.407,11,21,0.524,14,18,0.778,35,89,0.393,27,64,0.422,8,25,0.32,11,18,0.611
4/4/2017,2,UTA,POR,W ,106,87,240,39,74,0.527,26,51,0.51,13,23,0.565,15,19,0.789,33,83,0.398,27,57,0.474,6,26,0.231,15,17,0.882
4/4/2017,7,WAS,CHO,W ,118,111,240,43,85,0.506,26,51,0.51,17,34,0.5,15,18,0.833,40,79,0.506,28,45,0.622,12,34,0.353,19,22,0.864
4/3/2017,12,MIN,POR,W ,110,109,240,41,84,0.488,37,75,0.493,4,9,0.444,24,28,0.857,38,86,0.442,27,54,0.5,11,32,0.344,22,25,0.88
4/2/2017,9,BRK,ATL,W ,91,82,240,32,82,0.39,22,49,0.449,10,33,0.303,17,20,0.85,30,80,0.375,23,56,0.411,7,24,0.292,15,23,0.652
4/2/2017,12,CLE,IND,W ,135,130,290,47,95,0.495,29,52,0.558,18,43,0.419,23,33,0.697,48,105,0.457,32,64,0.5,16,41,0.39,18,20,0.9
4/2/2017,0,GSW,WAS,W ,139,115,240,50,88,0.568,34,52,0.654,16,36,0.444,23,26,0.885,43,92,0.467,33,65,0.508,10,27,0.37,19,25,0.76
4/2/2017,12,LAL,MEM,W ,108,103,240,40,85,0.471,33,66,0.5,7,19,0.368,21,27,0.778,40,80,0.5,27,50,0.54,13,30,0.433,10,14,0.714
4/2/2017,4,MIA,DEN,L ,113,116,240,42,87,0.483,29,60,0.483,13,27,0.481,16,21,0.762,44,87,0.506,39,67,0.582,5,20,0.25,23,27,0.852
4/2/2017,5,MIL,DAL,L ,105,109,240,39,77,0.506,27,43,0.628,12,34,0.353,15,18,0.833,38,73,0.521,24,37,0.649,14,36,0.389,19,20,0.95
4/2/2017,0,NOP,CHI,L ,110,117,240,33,81,0.407,23,51,0.451,10,30,0.333,34,35,0.971,45,92,0.489,32,66,0.485,13,26,0.5,14,18,0.778
4/2/2017,0,NYK,BOS,L ,94,110,240,33,85,0.388,26,60,0.433,7,25,0.28,21,25,0.84,40,72,0.556,28,35,0.8,12,37,0.324,18,26,0.692
4/2/2017,5,OKC,CHO,L ,101,113,240,39,84,0.464,27,53,0.509,12,31,0.387,11,12,0.917,37,77,0.481,26,47,0.553,11,30,0.367,28,32,0.875
4/2/2017,5,PHO,HOU,L ,116,123,240,42,100,0.42,34,66,0.515,8,34,0.235,24,29,0.828,47,100,0.47,33,62,0.532,14,38,0.368,15,23,0.652
4/2/2017,1,SAS,UTA,W ,109,103,240,40,77,0.519,30,58,0.517,10,19,0.526,19,22,0.864,43,89,0.483,34,65,0.523,9,24,0.375,8,13,0.615
4/2/2017,5,TOR,PHI,W ,113,105,240,46,85,0.541,40,66,0.606,6,19,0.316,15,19,0.789,36,80,0.45,25,44,0.568,11,36,0.306,22,25,0.88
4/1/2017,10,BRK,ORL,W ,121,111,240,50,94,0.532,42,63,0.667,8,31,0.258,13,16,0.813,45,91,0.495,35,66,0.53,10,25,0.4,11,15,0.733
4/1/2017,9,CHI,ATL,W ,106,104,240,40,85,0.471,28,55,0.509,12,30,0.4,14,14,1,40,90,0.444,29,62,0.468,11,28,0.393,13,17,0.765
4/1/2017,2,LAC,LAL,W ,115,104,240,38,69,0.551,27,44,0.614,11,25,0.44,28,34,0.824,39,90,0.433,33,67,0.493,6,23,0.261,20,30,0.667
4/1/2017,13,MIN,SAC,L ,117,123,240,39,87,0.448,30,60,0.5,9,27,0.333,30,38,0.789,44,78,0.564,33,59,0.559,11,19,0.579,24,33,0.727
4/1/2017,1,POR,PHO,W ,130,117,240,43,92,0.467,28,55,0.509,15,37,0.405,29,31,0.935,44,84,0.524,41,74,0.554,3,10,0.3,26,32,0.813
3/31/2017,18,BOS,ORL,W ,117,116,240,38,84,0.452,26,51,0.51,12,33,0.364,29,34,0.853,40,98,0.408,28,68,0.412,12,30,0.4,24,25,0.96
3/31/2017,11,CHO,DEN,W ,122,114,240,40,86,0.465,23,50,0.46,17,36,0.472,25,30,0.833,45,90,0.5,29,57,0.509,16,33,0.485,8,11,0.727
3/31/2017,10,CLE,PHI,W ,122,105,240,50,95,0.526,37,66,0.561,13,29,0.448,9,16,0.563,40,82,0.488,29,49,0.592,11,33,0.333,14,19,0.737
3/31/2017,2,GSW,HOU,W ,107,98,240,43,95,0.453,32,63,0.508,11,32,0.344,10,14,0.714,34,91,0.374,22,54,0.407,12,37,0.324,18,23,0.783
3/31/2017,2,MEM,DAL,W ,99,90,240,35,75,0.467,24,48,0.5,11,27,0.407,18,20,0.9,29,76,0.382,17,42,0.405,12,34,0.353,20,25,0.8
3/31/2017,4,MIA,NYK,L ,94,98,240,34,83,0.41,26,50,0.52,8,33,0.242,18,25,0.72,38,80,0.475,32,64,0.5,6,16,0.375,16,17,0.941
3/31/2017,2,MIL,DET,W ,108,105,265,35,84,0.417,21,48,0.438,14,36,0.389,24,34,0.706,44,97,0.454,37,67,0.552,7,30,0.233,10,16,0.625
3/31/2017,4,NOP,SAC,W ,117,89,240,46,95,0.484,36,62,0.581,10,33,0.303,15,19,0.789,35,90,0.389,29,70,0.414,6,20,0.3,13,17,0.765
3/31/2017,3,OKC,SAS,L ,95,100,240,33,81,0.407,27,60,0.45,6,21,0.286,23,27,0.852,37,85,0.435,28,58,0.483,9,27,0.333,17,27,0.63
3/31/2017,9,TOR,IND,W ,111,100,240,37,82,0.451,23,55,0.418,14,27,0.519,23,35,0.657,36,87,0.414,25,61,0.41,11,26,0.423,17,21,0.81
3/31/2017,12,UTA,WAS,W ,95,88,240,33,72,0.458,23,47,0.489,10,25,0.4,19,31,0.613,35,87,0.402,30,70,0.429,5,17,0.294,13,16,0.813
3/30/2017,12,CHI,CLE,W ,99,93,240,38,90,0.422,26,65,0.4,12,25,0.48,11,18,0.611,37,83,0.446,27,56,0.482,10,27,0.37,9,16,0.563
3/30/2017,11,DET,BRK,W ,90,89,240,36,86,0.419,29,68,0.426,7,18,0.389,11,17,0.647,35,92,0.38,25,61,0.41,10,31,0.323,9,12,0.75
3/30/2017,8,MIN,LAL,W ,119,104,240,43,89,0.483,33,68,0.485,10,21,0.476,23,30,0.767,40,84,0.476,31,57,0.544,9,27,0.333,15,16,0.938
3/30/2017,11,PHO,LAC,L ,118,124,240,49,92,0.533,42,69,0.609,7,23,0.304,13,24,0.542,44,80,0.55,32,58,0.552,12,22,0.545,24,34,0.706
3/30/2017,12,POR,HOU,W ,117,107,240,43,90,0.478,30,57,0.526,13,33,0.394,18,22,0.818,40,91,0.44,32,57,0.561,8,34,0.235,19,23,0.826
3/29/2017,6,BOS,MIL,L ,100,103,240,35,88,0.398,23,51,0.451,12,37,0.324,18,23,0.783,41,78,0.526,33,56,0.589,8,22,0.364,13,17,0.765
3/29/2017,3,LAC,WAS,W ,133,124,240,47,83,0.566,35,53,0.66,12,30,0.4,27,37,0.73,46,93,0.495,33,59,0.559,13,34,0.382,19,29,0.655
3/29/2017,0,MEM,IND,W ,110,97,240,41,88,0.466,29,56,0.518,12,32,0.375,16,18,0.889,37,85,0.435,27,60,0.45,10,25,0.4,13,15,0.867
3/29/2017,5,NOP,DAL,W ,121,118,240,42,84,0.5,30,54,0.556,12,30,0.4,25,33,0.758,44,91,0.484,30,64,0.469,14,27,0.519,16,17,0.941
3/29/2017,10,NYK,MIA,L ,88,105,240,33,89,0.371,28,64,0.438,5,25,0.2,17,21,0.81,40,84,0.476,28,59,0.475,12,25,0.48,13,17,0.765
3/29/2017,4,ORL,OKC,L ,106,114,265,39,97,0.402,30,67,0.448,9,30,0.3,19,27,0.704,43,102,0.422,33,69,0.478,10,33,0.303,18,28,0.643
3/29/2017,1,PHI,ATL,L ,92,99,240,36,87,0.414,25,48,0.521,11,39,0.282,9,11,0.818,34,80,0.425,25,62,0.403,9,18,0.5,22,26,0.846
3/29/2017,0,SAC,UTA,L ,82,112,240,34,75,0.453,32,60,0.533,2,15,0.133,12,18,0.667,42,79,0.532,29,48,0.604,13,31,0.419,15,19,0.789
3/29/2017,1,SAS,GSW,L ,98,110,240,34,83,0.41,25,59,0.424,9,24,0.375,21,26,0.808,43,85,0.506,30,59,0.508,13,26,0.5,11,11,1
3/29/2017,5,TOR,CHO,L ,106,110,240,38,83,0.458,27,52,0.519,11,31,0.355,19,24,0.792,39,86,0.453,23,54,0.426,16,32,0.5,16,21,0.762
3/28/2017,2,ATL,PHO,W ,95,91,240,34,85,0.4,28,58,0.483,6,27,0.222,21,29,0.724,35,96,0.365,28,65,0.431,7,31,0.226,14,24,0.583
3/28/2017,21,BRK,PHI,L ,101,106,240,38,94,0.404,29,62,0.468,9,32,0.281,16,24,0.667,39,91,0.429,29,58,0.5,10,33,0.303,18,21,0.857
3/28/2017,0,CHO,MIL,L ,108,118,240,39,80,0.488,32,52,0.615,7,28,0.25,23,29,0.793,46,74,0.622,32,44,0.727,14,30,0.467,12,17,0.706
3/28/2017,12,DET,MIA,L ,96,97,240,36,85,0.424,28,58,0.483,8,27,0.296,16,21,0.762,36,79,0.456,31,58,0.534,5,21,0.238,20,28,0.714
3/28/2017,0,HOU,GSW,L ,106,113,240,33,85,0.388,28,54,0.519,5,31,0.161,35,39,0.897,45,88,0.511,34,47,0.723,11,41,0.268,12,16,0.75
3/28/2017,10,IND,MIN,L ,114,115,240,40,81,0.494,35,63,0.556,5,18,0.278,29,35,0.829,37,78,0.474,28,58,0.483,9,20,0.45,32,37,0.865
3/28/2017,10,LAL,WAS,L ,108,119,240,43,85,0.506,35,63,0.556,8,22,0.364,14,16,0.875,48,94,0.511,42,71,0.592,6,23,0.261,17,25,0.68
3/28/2017,7,POR,DEN,W ,122,113,240,45,91,0.495,37,64,0.578,8,27,0.296,24,33,0.727,44,94,0.468,35,64,0.547,9,30,0.3,16,20,0.8
3/27/2017,4,DAL,OKC,L ,91,92,240,33,80,0.413,23,51,0.451,10,29,0.345,15,19,0.789,37,85,0.435,31,62,0.5,6,23,0.261,12,14,0.857
3/27/2017,1,NYK,DET,W ,109,95,240,45,84,0.536,38,63,0.603,7,21,0.333,12,13,0.923,36,84,0.429,27,61,0.443,9,23,0.391,14,21,0.667
3/27/2017,16,SAC,MEM,W ,91,90,240,31,67,0.463,25,42,0.595,6,25,0.24,23,30,0.767,31,90,0.344,26,64,0.406,5,26,0.192,23,29,0.793
3/27/2017,2,SAS,CLE,W ,103,74,240,41,86,0.477,34,60,0.567,7,26,0.269,14,17,0.824,31,83,0.373,27,57,0.474,4,26,0.154,8,13,0.615
3/27/2017,7,TOR,ORL,W ,131,112,240,49,83,0.59,39,68,0.574,10,15,0.667,23,35,0.657,43,88,0.489,39,68,0.574,4,20,0.2,22,28,0.786
3/27/2017,4,UTA,NOP,W ,108,100,240,41,85,0.482,26,58,0.448,15,27,0.556,11,18,0.611,37,80,0.463,27,55,0.491,10,25,0.4,16,24,0.667
3/26/2017,5,ATL,BRK,L ,92,107,240,34,98,0.347,29,71,0.408,5,27,0.185,19,32,0.594,38,86,0.442,32,64,0.5,6,22,0.273,25,30,0.833
3/26/2017,14,BOS,MIA,W ,112,108,240,41,77,0.532,33,53,0.623,8,24,0.333,22,25,0.88,41,91,0.451,34,62,0.548,7,29,0.241,19,24,0.792
3/26/2017,0,CHO,PHO,W ,120,106,240,42,87,0.483,28,57,0.491,14,30,0.467,22,24,0.917,41,81,0.506,35,65,0.538,6,16,0.375,18,22,0.818
3/26/2017,5,DEN,NOP,L ,90,115,240,36,95,0.379,30,70,0.429,6,25,0.24,12,14,0.857,48,97,0.495,39,70,0.557,9,27,0.333,10,12,0.833
3/26/2017,15,GSW,MEM,W ,106,94,240,39,71,0.549,22,40,0.55,17,31,0.548,11,15,0.733,38,85,0.447,30,56,0.536,8,29,0.276,10,15,0.667
3/26/2017,0,HOU,OKC,W ,137,125,240,50,79,0.633,30,40,0.75,20,39,0.513,17,21,0.81,47,94,0.5,36,64,0.563,11,30,0.367,20,28,0.714
3/26/2017,7,IND,PHI,W ,107,94,240,38,89,0.427,31,72,0.431,7,17,0.412,24,29,0.828,35,88,0.398,21,47,0.447,14,41,0.341,10,14,0.714
3/26/2017,8,LAC,SAC,L ,97,98,240,32,78,0.41,22,49,0.449,10,29,0.345,23,28,0.821,38,84,0.452,25,56,0.446,13,28,0.464,9,13,0.692
3/26/2017,0,LAL,POR,L ,81,97,240,33,84,0.393,28,63,0.444,5,21,0.238,10,17,0.588,36,89,0.404,24,61,0.393,12,28,0.429,13,18,0.722
3/26/2017,14,MIL,CHI,L ,94,109,240,37,84,0.44,30,61,0.492,7,23,0.304,13,17,0.765,46,85,0.541,36,64,0.563,10,21,0.476,7,10,0.7
3/25/2017,4,CLE,WAS,L ,115,127,240,41,83,0.494,29,50,0.58,12,33,0.364,21,27,0.778,49,82,0.598,41,64,0.641,8,18,0.444,21,26,0.808
3/25/2017,0,DAL,TOR,L ,86,94,240,31,82,0.378,24,54,0.444,7,28,0.25,17,20,0.85,39,81,0.481,30,60,0.5,9,21,0.429,7,9,0.778
3/25/2017,1,LAC,UTA,W ,108,95,240,38,84,0.452,31,57,0.544,7,27,0.259,25,28,0.893,37,86,0.43,29,60,0.483,8,26,0.308,13,18,0.722
3/25/2017,2,POR,MIN,W ,112,100,240,45,71,0.634,34,49,0.694,11,22,0.5,11,17,0.647,37,76,0.487,35,66,0.53,2,10,0.2,24,32,0.75
3/25/2017,2,SAS,NYK,W ,106,98,240,45,99,0.455,35,74,0.473,10,25,0.4,6,8,0.75,41,87,0.471,38,77,0.494,3,10,0.3,13,15,0.867
3/24/2017,0,BOS,PHO,W ,130,120,240,44,94,0.468,30,53,0.566,14,41,0.341,28,35,0.8,39,86,0.453,33,67,0.493,6,19,0.316,36,49,0.735
3/24/2017,1,CHI,PHI,L ,107,117,240,37,91,0.407,27,67,0.403,10,24,0.417,23,31,0.742,46,83,0.554,38,58,0.655,8,25,0.32,17,23,0.739
3/24/2017,4,CHO,CLE,L ,105,112,240,38,90,0.422,28,52,0.538,10,38,0.263,19,24,0.792,41,74,0.554,32,49,0.653,9,25,0.36,21,24,0.875
3/24/2017,4,GSW,SAC,W ,114,100,240,44,89,0.494,34,58,0.586,10,31,0.323,16,18,0.889,40,83,0.482,30,62,0.484,10,21,0.476,10,13,0.769
3/24/2017,6,HOU,NOP,W ,117,107,240,44,93,0.473,30,54,0.556,14,39,0.359,15,20,0.75,41,91,0.451,27,53,0.509,14,38,0.368,11,14,0.786
3/24/2017,0,IND,DEN,L ,117,125,240,48,95,0.505,35,71,0.493,13,24,0.542,8,11,0.727,39,82,0.476,32,55,0.582,7,27,0.259,40,43,0.93
3/24/2017,13,LAL,MIN,W ,130,119,265,46,88,0.523,32,65,0.492,14,23,0.609,24,28,0.857,46,95,0.484,39,74,0.527,7,21,0.333,20,22,0.909
3/24/2017,17,MIL,ATL,W ,100,97,240,39,88,0.443,31,61,0.508,8,27,0.296,14,16,0.875,34,83,0.41,26,61,0.426,8,22,0.364,21,24,0.875
3/24/2017,1,ORL,DET,W ,115,87,240,47,91,0.516,35,65,0.538,12,26,0.462,9,13,0.692,34,96,0.354,32,74,0.432,2,22,0.091,17,20,0.85
3/24/2017,5,WAS,BRK,W ,129,108,240,49,97,0.505,39,71,0.549,10,26,0.385,21,22,0.955,43,82,0.524,40,67,0.597,3,15,0.2,19,26,0.731
3/23/2017,3,BRK,PHO,W ,126,98,240,43,95,0.453,35,66,0.53,8,29,0.276,32,42,0.762,34,93,0.366,27,68,0.397,7,25,0.28,23,34,0.676
3/23/2017,11,DAL,LAC,W ,97,95,240,38,82,0.463,29,56,0.518,9,26,0.346,12,18,0.667,36,80,0.45,27,53,0.509,9,27,0.333,14,21,0.667
3/23/2017,3,MIA,TOR,L ,84,101,240,32,82,0.39,26,59,0.441,6,23,0.261,14,23,0.609,35,79,0.443,29,56,0.518,6,23,0.261,25,32,0.781
3/23/2017,0,POR,NYK,W ,110,95,240,39,80,0.488,28,59,0.475,11,21,0.524,21,29,0.724,36,88,0.409,31,66,0.47,5,22,0.227,18,20,0.9
3/23/2017,2,SAS,MEM,W ,97,90,240,37,77,0.481,29,51,0.569,8,26,0.308,15,23,0.652,34,78,0.436,24,49,0.49,10,29,0.345,12,15,0.8
3/22/2017,7,BOS,IND,W ,109,100,240,43,84,0.512,32,57,0.561,11,27,0.407,12,14,0.857,38,87,0.437,27,59,0.458,11,28,0.393,13,19,0.684
3/22/2017,8,CHI,DET,W ,117,95,240,47,80,0.588,36,57,0.632,11,23,0.478,12,19,0.632,39,88,0.443,32,68,0.471,7,20,0.35,10,17,0.588
3/22/2017,4,DEN,CLE,W ,126,113,240,51,96,0.531,40,70,0.571,11,26,0.423,13,13,1,43,85,0.506,28,48,0.583,15,37,0.405,12,14,0.857
3/22/2017,11,OKC,PHI,W ,122,97,240,48,88,0.545,44,72,0.611,4,16,0.25,22,30,0.733,37,87,0.425,29,62,0.468,8,25,0.32,15,17,0.882
3/22/2017,5,ORL,CHO,L ,102,109,240,40,88,0.455,26,48,0.542,14,40,0.35,8,10,0.8,42,90,0.467,33,63,0.524,9,27,0.333,16,18,0.889
3/22/2017,9,SAC,MIL,L ,98,116,240,41,84,0.488,31,58,0.534,10,26,0.385,6,10,0.6,43,81,0.531,27,46,0.587,16,35,0.457,14,19,0.737
3/22/2017,5,UTA,NYK,W ,108,101,240,41,90,0.456,34,62,0.548,7,28,0.25,19,29,0.655,38,80,0.475,29,59,0.492,9,21,0.429,16,18,0.889
3/22/2017,12,WAS,ATL,W ,104,100,240,38,95,0.4,27,61,0.443,11,34,0.324,17,23,0.739,34,86,0.395,26,61,0.426,8,25,0.32,24,29,0.828
3/21/2017,5,BRK,DET,W ,98,96,240,38,88,0.432,28,59,0.475,10,29,0.345,12,19,0.632,40,92,0.435,35,69,0.507,5,23,0.217,11,16,0.688
3/21/2017,8,DAL,GSW,L ,87,112,240,33,92,0.359,22,58,0.379,11,34,0.324,10,12,0.833,43,78,0.551,30,48,0.625,13,30,0.433,13,16,0.813
3/21/2017,0,LAL,LAC,L ,109,133,240,43,92,0.467,37,72,0.514,6,20,0.3,17,27,0.63,45,84,0.536,30,51,0.588,15,33,0.455,28,32,0.875
3/21/2017,7,MIA,PHO,W ,112,97,240,42,96,0.438,31,69,0.449,11,27,0.407,17,23,0.739,36,82,0.439,32,66,0.485,4,16,0.25,21,29,0.724
3/21/2017,13,MIN,SAS,L ,93,100,240,32,72,0.444,25,57,0.439,7,15,0.467,22,25,0.88,37,77,0.481,29,53,0.547,8,24,0.333,18,22,0.818
3/21/2017,3,NOP,MEM,W ,95,82,240,35,88,0.398,26,59,0.441,9,29,0.31,16,19,0.842,32,79,0.405,23,44,0.523,9,35,0.257,9,13,0.692
3/21/2017,3,POR,MIL,L ,90,93,240,35,83,0.422,31,62,0.5,4,21,0.19,16,26,0.615,38,90,0.422,31,74,0.419,7,16,0.438,10,12,0.833
3/21/2017,1,TOR,CHI,W ,122,120,265,47,95,0.495,39,72,0.542,8,23,0.348,20,27,0.741,42,90,0.467,28,53,0.528,14,37,0.378,22,27,0.815
3/20/2017,8,BOS,WAS,W ,110,102,240,40,93,0.43,30,60,0.5,10,33,0.303,20,28,0.714,37,86,0.43,29,51,0.569,8,35,0.229,20,26,0.769
3/20/2017,1,CHO,ATL,W ,105,90,240,40,80,0.5,28,50,0.56,12,30,0.4,13,20,0.65,37,84,0.44,25,47,0.532,12,37,0.324,4,10,0.4
3/20/2017,9,HOU,DEN,W ,125,124,240,45,89,0.506,28,51,0.549,17,38,0.447,18,23,0.783,44,86,0.512,32,57,0.561,12,29,0.414,24,26,0.923
3/20/2017,4,IND,UTA,W ,107,100,240,38,87,0.437,28,67,0.418,10,20,0.5,21,23,0.913,40,88,0.455,34,63,0.54,6,25,0.24,14,20,0.7
3/20/2017,4,LAC,NYK,W ,114,105,240,43,87,0.494,33,56,0.589,10,31,0.323,18,24,0.75,40,89,0.449,34,65,0.523,6,24,0.25,19,24,0.792
3/20/2017,3,OKC,GSW,L ,95,111,240,37,87,0.425,33,66,0.5,4,21,0.19,17,31,0.548,40,83,0.482,25,50,0.5,15,33,0.455,16,21,0.762
3/20/2017,10,ORL,PHI,W ,112,109,265,35,94,0.372,31,71,0.437,4,23,0.174,38,46,0.826,39,102,0.382,30,68,0.441,9,34,0.265,22,24,0.917
3/19/2017,0,BRK,DAL,L ,104,111,240,31,72,0.431,18,41,0.439,13,31,0.419,29,38,0.763,41,76,0.539,31,51,0.608,10,25,0.4,19,25,0.76
3/19/2017,9,DET,PHO,W ,112,95,240,40,92,0.435,28,67,0.418,12,25,0.48,20,30,0.667,35,99,0.354,29,77,0.377,6,22,0.273,19,30,0.633
3/19/2017,6,LAL,CLE,L ,120,125,240,47,91,0.516,36,64,0.563,11,27,0.407,15,19,0.789,45,85,0.529,32,49,0.653,13,36,0.361,22,27,0.815
3/19/2017,8,MIA,POR,L ,104,115,240,41,88,0.466,32,58,0.552,9,30,0.3,13,20,0.65,42,83,0.506,29,57,0.509,13,26,0.5,18,24,0.75
3/19/2017,3,NOP,MIN,W ,123,109,240,49,90,0.544,35,60,0.583,14,30,0.467,11,15,0.733,44,86,0.512,35,61,0.574,9,25,0.36,12,17,0.706
3/19/2017,4,PHI,BOS,W ,105,99,240,41,88,0.466,29,55,0.527,12,33,0.364,11,15,0.733,34,84,0.405,28,55,0.509,6,29,0.207,25,29,0.862
3/19/2017,3,SAS,SAC,W ,118,102,240,43,87,0.494,32,59,0.542,11,28,0.393,21,27,0.778,41,83,0.494,34,73,0.466,7,10,0.7,13,17,0.765
3/19/2017,3,TOR,IND,W ,116,91,240,45,91,0.495,33,64,0.516,12,27,0.444,14,16,0.875,33,80,0.413,27,57,0.474,6,23,0.261,19,26,0.731
3/18/2017,0,ATL,POR,L ,97,113,240,32,88,0.364,25,62,0.403,7,26,0.269,26,32,0.813,44,87,0.506,36,69,0.522,8,18,0.444,17,19,0.895
3/18/2017,7,CHI,UTA,W ,95,86,240,38,80,0.475,31,61,0.508,7,19,0.368,12,14,0.857,31,81,0.383,24,56,0.429,7,25,0.28,17,25,0.68
3/18/2017,15,CHO,WAS,W ,98,93,240,35,82,0.427,26,58,0.448,9,24,0.375,19,27,0.704,29,79,0.367,18,46,0.391,11,33,0.333,24,31,0.774
3/18/2017,13,DEN,HOU,L ,105,109,240,38,89,0.427,28,58,0.483,10,31,0.323,19,30,0.633,38,83,0.458,33,59,0.559,5,24,0.208,28,35,0.8
3/18/2017,1,GSW,MIL,W ,117,92,240,45,75,0.6,33,52,0.635,12,23,0.522,15,19,0.789,36,89,0.404,27,62,0.435,9,27,0.333,11,14,0.786
3/18/2017,5,LAC,CLE,W ,108,78,240,40,78,0.513,32,52,0.615,8,26,0.308,20,29,0.69,32,83,0.386,27,56,0.482,5,27,0.185,9,13,0.692
3/18/2017,15,MEM,SAS,W ,104,96,240,32,76,0.421,19,46,0.413,13,30,0.433,27,31,0.871,33,75,0.44,24,47,0.511,9,28,0.321,21,22,0.955
3/18/2017,2,OKC,SAC,W ,110,94,240,41,82,0.5,31,56,0.554,10,26,0.385,18,25,0.72,35,85,0.412,30,64,0.469,5,21,0.238,19,23,0.826
3/17/2017,8,BRK,BOS,L ,95,98,240,30,83,0.361,19,48,0.396,11,35,0.314,24,30,0.8,34,85,0.4,27,56,0.482,7,29,0.241,23,29,0.793
3/17/2017,6,DET,TOR,L ,75,87,240,29,83,0.349,26,63,0.413,3,20,0.15,14,21,0.667,30,78,0.385,21,51,0.412,9,27,0.333,18,20,0.9
3/17/2017,6,LAL,MIL,L ,103,107,240,38,84,0.452,27,55,0.491,11,29,0.379,16,26,0.615,40,82,0.488,36,58,0.621,4,24,0.167,23,30,0.767
3/17/2017,0,MIA,MIN,W ,123,105,240,50,85,0.588,42,59,0.712,8,26,0.308,15,19,0.789,41,82,0.5,39,70,0.557,2,12,0.167,21,22,0.955
3/17/2017,2,NOP,HOU,W ,128,112,240,49,92,0.533,37,58,0.638,12,34,0.353,18,24,0.75,37,91,0.407,24,51,0.471,13,40,0.325,25,32,0.781
3/17/2017,4,PHI,DAL,W ,116,74,240,42,80,0.525,30,51,0.588,12,29,0.414,20,23,0.87,30,87,0.345,25,64,0.391,5,23,0.217,9,17,0.529
3/17/2017,18,PHO,ORL,L ,103,109,240,38,87,0.437,36,73,0.493,2,14,0.143,25,30,0.833,42,96,0.438,35,73,0.479,7,23,0.304,18,21,0.857
3/17/2017,3,WAS,CHI,W ,112,107,240,46,101,0.455,36,75,0.48,10,26,0.385,10,12,0.833,44,88,0.5,37,61,0.607,7,27,0.259,12,18,0.667
3/16/2017,21,ATL,MEM,L ,91,103,240,29,71,0.408,21,44,0.477,8,27,0.296,25,34,0.735,39,92,0.424,29,64,0.453,10,28,0.357,15,18,0.833
3/16/2017,12,CLE,UTA,W ,91,83,240,36,86,0.419,27,53,0.509,9,33,0.273,10,19,0.526,34,82,0.415,29,61,0.475,5,21,0.238,10,14,0.714
3/16/2017,2,DEN,LAC,W ,129,114,240,46,86,0.535,31,58,0.534,15,28,0.536,22,26,0.846,44,84,0.524,28,52,0.538,16,32,0.5,10,15,0.667
3/16/2017,0,GSW,ORL,W ,122,92,240,50,87,0.575,40,61,0.656,10,26,0.385,12,23,0.522,35,94,0.372,28,67,0.418,7,27,0.259,15,21,0.714
3/16/2017,8,NYK,BRK,L ,110,121,240,41,88,0.466,38,70,0.543,3,18,0.167,25,26,0.962,41,86,0.477,31,54,0.574,10,32,0.313,29,35,0.829
3/16/2017,0,TOR,OKC,L ,102,123,240,37,81,0.457,32,61,0.525,5,20,0.25,23,30,0.767,47,88,0.534,33,63,0.524,14,25,0.56,15,19,0.789
3/15/2017,5,BOS,MIN,W ,117,104,240,43,79,0.544,30,46,0.652,13,33,0.394,18,21,0.857,40,91,0.44,32,64,0.5,8,27,0.296,16,20,0.8
3/15/2017,3,CHI,MEM,L ,91,98,240,34,91,0.374,23,63,0.365,11,28,0.393,12,15,0.8,36,85,0.424,25,54,0.463,11,31,0.355,15,18,0.833
3/15/2017,3,DET,UTA,L ,83,97,240,36,86,0.419,33,73,0.452,3,13,0.231,8,12,0.667,36,77,0.468,23,49,0.469,13,28,0.464,12,16,0.75
3/15/2017,2,HOU,LAL,W ,139,100,240,50,91,0.549,32,48,0.667,18,43,0.419,21,32,0.656,42,91,0.462,39,66,0.591,3,25,0.12,13,18,0.722
3/15/2017,2,IND,CHO,W ,98,77,240,39,73,0.534,27,45,0.6,12,28,0.429,8,9,0.889,32,80,0.4,29,57,0.509,3,23,0.13,10,13,0.769
3/15/2017,8,LAC,MIL,L ,96,97,240,35,75,0.467,30,51,0.588,5,24,0.208,21,29,0.724,34,76,0.447,24,47,0.511,10,29,0.345,19,25,0.76
3/15/2017,6,MIA,NOP,W ,120,112,240,44,87,0.506,28,52,0.538,16,35,0.457,16,19,0.842,42,88,0.477,33,66,0.5,9,22,0.409,19,28,0.679
3/15/2017,6,PHO,SAC,L ,101,107,240,43,107,0.402,37,82,0.451,6,25,0.24,9,14,0.643,38,79,0.481,32,65,0.492,6,14,0.429,25,34,0.735
3/15/2017,21,SAS,POR,L ,106,110,240,42,88,0.477,31,62,0.5,11,26,0.423,11,15,0.733,38,80,0.475,29,58,0.5,9,22,0.409,25,28,0.893
3/15/2017,1,WAS,DAL,L ,107,112,240,40,82,0.488,28,52,0.538,12,30,0.4,15,21,0.714,40,79,0.506,26,47,0.553,14,32,0.438,18,25,0.72
3/14/2017,11,BRK,OKC,L ,104,122,240,33,71,0.465,21,47,0.447,12,24,0.5,26,30,0.867,44,89,0.494,34,67,0.507,10,22,0.455,24,34,0.706
3/14/2017,3,CLE,DET,W ,128,96,240,46,77,0.597,27,47,0.574,19,30,0.633,17,23,0.739,37,99,0.374,33,80,0.413,4,19,0.211,18,19,0.947
3/14/2017,25,GSW,PHI,W ,106,104,240,32,88,0.364,18,56,0.321,14,32,0.438,28,35,0.8,39,89,0.438,31,62,0.5,8,27,0.296,18,27,0.667
3/14/2017,1,NOP,POR,W ,100,77,240,38,80,0.475,32,59,0.542,6,21,0.286,18,30,0.6,23,76,0.303,12,44,0.273,11,32,0.344,20,26,0.769
3/14/2017,5,NYK,IND,W ,87,81,240,35,83,0.422,26,55,0.473,9,28,0.321,8,13,0.615,32,87,0.368,24,58,0.414,8,29,0.276,9,15,0.6
3/13/2017,5,CHO,CHI,L ,109,115,240,43,93,0.462,36,64,0.563,7,29,0.241,16,19,0.842,41,92,0.446,27,52,0.519,14,40,0.35,19,22,0.864
3/13/2017,2,DEN,LAL,W ,129,101,240,45,84,0.536,28,46,0.609,17,38,0.447,22,25,0.88,42,97,0.433,36,77,0.468,6,20,0.3,11,19,0.579
3/13/2017,0,MEM,MIL,W ,113,93,240,41,79,0.519,27,52,0.519,14,27,0.519,17,23,0.739,31,67,0.463,17,41,0.415,14,26,0.538,17,20,0.85
3/13/2017,0,MIN,WAS,W ,119,104,240,45,86,0.523,35,65,0.538,10,21,0.476,19,22,0.864,36,84,0.429,29,58,0.5,7,26,0.269,25,31,0.806
3/13/2017,14,SAC,ORL,W ,120,115,240,44,82,0.537,28,52,0.538,16,30,0.533,16,21,0.762,45,98,0.459,32,64,0.5,13,34,0.382,12,12,1
3/13/2017,6,SAS,ATL,W ,107,99,240,39,81,0.481,23,47,0.489,16,34,0.471,13,17,0.765,37,81,0.457,31,59,0.525,6,22,0.273,19,30,0.633
3/13/2017,8,TOR,DAL,W ,100,78,240,37,78,0.474,28,53,0.528,9,25,0.36,17,18,0.944,31,85,0.365,24,60,0.4,7,25,0.28,9,13,0.692
3/13/2017,3,UTA,LAC,W ,114,108,240,41,78,0.526,27,57,0.474,14,21,0.667,18,22,0.818,39,78,0.5,27,48,0.563,12,30,0.4,18,23,0.783
3/12/2017,0,BOS,CHI,W ,100,80,240,40,86,0.465,24,49,0.49,16,37,0.432,4,4,1,33,87,0.379,26,62,0.419,7,25,0.28,7,9,0.778
3/12/2017,2,BRK,NYK,W ,120,112,240,40,87,0.46,21,49,0.429,19,38,0.5,21,29,0.724,39,94,0.415,31,71,0.437,8,23,0.348,26,32,0.813
3/12/2017,16,HOU,CLE,W ,117,112,240,41,96,0.427,25,51,0.49,16,45,0.356,19,28,0.679,42,80,0.525,25,37,0.676,17,43,0.395,11,13,0.846
3/12/2017,10,IND,MIA,W ,102,98,240,35,82,0.427,30,67,0.448,5,15,0.333,27,32,0.844,39,94,0.415,30,62,0.484,9,32,0.281,11,16,0.688
3/12/2017,13,LAL,PHI,L ,116,118,240,44,88,0.5,40,68,0.588,4,20,0.2,24,28,0.857,41,79,0.519,31,55,0.564,10,24,0.417,26,32,0.813
3/12/2017,8,PHO,POR,L ,101,110,240,41,93,0.441,36,79,0.456,5,14,0.357,14,20,0.7,43,86,0.5,36,64,0.563,7,22,0.318,17,25,0.68
3/11/2017,24,CHO,NOP,L ,122,125,265,46,102,0.451,33,56,0.589,13,46,0.283,17,20,0.85,50,99,0.505,36,65,0.554,14,34,0.412,11,16,0.688
3/11/2017,16,DAL,PHO,L ,98,100,240,28,74,0.378,19,48,0.396,9,26,0.346,33,36,0.917,38,83,0.458,32,62,0.516,6,21,0.286,18,20,0.9
3/11/2017,2,DET,NYK,W ,112,92,240,46,96,0.479,37,69,0.536,9,27,0.333,11,19,0.579,36,82,0.439,23,52,0.442,13,30,0.433,7,11,0.636
3/11/2017,21,LAC,PHI,W ,112,100,240,40,81,0.494,32,56,0.571,8,25,0.32,24,29,0.828,40,84,0.476,30,54,0.556,10,30,0.333,10,14,0.714
3/11/2017,0,MEM,ATL,L ,90,107,240,34,90,0.378,29,61,0.475,5,29,0.172,17,23,0.739,36,72,0.5,21,42,0.5,15,30,0.5,20,26,0.769
3/11/2017,3,MIA,TOR,W ,104,89,240,35,72,0.486,24,44,0.545,11,28,0.393,23,33,0.697,33,88,0.375,31,73,0.425,2,15,0.133,21,25,0.84
3/11/2017,13,MIL,MIN,W ,102,95,240,37,80,0.463,29,60,0.483,8,20,0.4,20,23,0.87,37,81,0.457,32,68,0.471,5,13,0.385,16,21,0.762
3/11/2017,2,OKC,UTA,W ,112,104,240,43,86,0.5,35,63,0.556,8,23,0.348,18,24,0.75,36,75,0.48,27,55,0.491,9,20,0.45,23,28,0.821
3/11/2017,5,ORL,CLE,L ,104,116,240,38,96,0.396,34,75,0.453,4,21,0.19,24,28,0.857,43,86,0.5,28,47,0.596,15,39,0.385,15,25,0.6
3/11/2017,9,POR,WAS,L ,124,125,265,48,94,0.511,32,62,0.516,16,32,0.5,12,16,0.75,47,90,0.522,35,65,0.538,12,25,0.48,19,28,0.679
3/11/2017,2,SAC,DEN,L ,92,105,240,36,82,0.439,28,59,0.475,8,23,0.348,12,20,0.6,40,85,0.471,31,51,0.608,9,34,0.265,16,18,0.889
3/11/2017,2,SAS,GSW,W ,107,85,240,40,77,0.519,28,50,0.56,12,27,0.444,15,18,0.833,33,92,0.359,28,75,0.373,5,17,0.294,14,23,0.609
3/10/2017,15,ATL,TOR,W ,105,99,240,39,75,0.52,31,53,0.585,8,22,0.364,19,29,0.655,37,92,0.402,33,67,0.493,4,25,0.16,21,27,0.778
3/10/2017,5,CHI,HOU,L ,94,115,240,38,98,0.388,29,59,0.492,9,39,0.231,9,12,0.75,37,89,0.416,22,42,0.524,15,47,0.319,26,32,0.813
3/10/2017,0,CHO,ORL,W ,121,81,240,47,79,0.595,37,58,0.638,10,21,0.476,17,20,0.85,31,76,0.408,26,49,0.531,5,27,0.185,14,22,0.636
3/10/2017,5,DAL,BRK,W ,105,96,240,33,78,0.423,19,45,0.422,14,33,0.424,25,28,0.893,34,78,0.436,25,47,0.532,9,31,0.29,19,23,0.826
3/10/2017,0,DEN,BOS,W ,119,99,240,45,85,0.529,33,54,0.611,12,31,0.387,17,22,0.773,34,81,0.42,22,48,0.458,12,33,0.364,19,23,0.826
3/10/2017,1,MIL,IND,W ,99,85,240,33,64,0.516,26,47,0.553,7,17,0.412,26,30,0.867,33,75,0.44,31,57,0.544,2,18,0.111,17,22,0.773
3/10/2017,7,MIN,GSW,W ,103,102,240,39,88,0.443,35,74,0.473,4,14,0.286,21,27,0.778,41,88,0.466,34,64,0.531,7,24,0.292,13,17,0.765
3/10/2017,10,SAC,WAS,L ,122,130,265,44,92,0.478,32,69,0.464,12,23,0.522,22,28,0.786,52,104,0.5,43,78,0.551,9,26,0.346,17,19,0.895
3/9/2017,4,DET,CLE,W ,106,101,240,41,88,0.466,32,62,0.516,9,26,0.346,15,19,0.789,39,84,0.464,28,45,0.622,11,39,0.282,12,19,0.632
3/9/2017,6,MEM,LAC,L ,98,114,240,37,83,0.446,30,63,0.476,7,20,0.35,17,22,0.773,40,78,0.513,29,48,0.604,11,30,0.367,23,28,0.821
3/9/2017,2,OKC,SAS,W ,102,92,240,41,89,0.461,35,69,0.507,6,20,0.3,14,21,0.667,35,84,0.417,29,65,0.446,6,19,0.316,16,20,0.8
3/9/2017,7,PHO,LAL,L ,110,122,240,42,91,0.462,36,72,0.5,6,19,0.316,20,25,0.8,47,98,0.48,35,71,0.493,12,27,0.444,16,24,0.667
3/9/2017,10,POR,PHI,W ,114,108,265,40,88,0.455,34,67,0.507,6,21,0.286,28,33,0.848,41,94,0.436,30,65,0.462,11,29,0.379,15,20,0.75
3/8/2017,5,ATL,BRK,W ,110,105,240,41,95,0.432,37,75,0.493,4,20,0.2,24,32,0.75,37,80,0.463,26,47,0.553,11,33,0.333,20,25,0.8
3/8/2017,9,DEN,WAS,L ,113,123,240,46,87,0.529,33,59,0.559,13,28,0.464,8,17,0.471,50,88,0.568,39,62,0.629,11,26,0.423,12,19,0.632
3/8/2017,9,GSW,BOS,L ,86,99,240,37,84,0.44,31,54,0.574,6,30,0.2,6,9,0.667,37,84,0.44,27,55,0.491,10,29,0.345,15,19,0.789
3/8/2017,4,HOU,UTA,L ,108,115,240,35,79,0.443,27,47,0.574,8,32,0.25,30,40,0.75,41,76,0.539,29,45,0.644,12,31,0.387,21,24,0.875
3/8/2017,2,IND,DET,W ,115,98,240,44,88,0.5,33,65,0.508,11,23,0.478,16,19,0.842,39,89,0.438,32,63,0.508,7,26,0.269,13,22,0.591
3/8/2017,11,MIA,CHO,W ,108,101,240,37,85,0.435,20,44,0.455,17,41,0.415,17,24,0.708,37,80,0.463,30,59,0.508,7,21,0.333,20,21,0.952
3/8/2017,4,MIL,NYK,W ,104,93,240,37,86,0.43,29,60,0.483,8,26,0.308,22,28,0.786,39,84,0.464,32,63,0.508,7,21,0.333,8,12,0.667
3/8/2017,1,MIN,LAC,W ,107,91,240,42,86,0.488,37,66,0.561,5,20,0.25,18,20,0.9,35,83,0.422,26,59,0.441,9,24,0.375,12,18,0.667
3/8/2017,11,NOP,TOR,L ,87,94,240,34,80,0.425,25,51,0.49,9,29,0.31,10,13,0.769,36,76,0.474,28,55,0.509,8,21,0.381,14,23,0.609
3/8/2017,8,ORL,CHI,W ,98,91,240,37,89,0.416,30,64,0.469,7,25,0.28,17,21,0.81,36,81,0.444,24,53,0.453,12,28,0.429,7,11,0.636
3/8/2017,1,SAS,SAC,W ,114,104,240,42,84,0.5,28,55,0.509,14,29,0.483,16,21,0.762,42,86,0.488,35,67,0.522,7,19,0.368,13,16,0.813
3/7/2017,1,DAL,LAL,W ,122,111,240,45,83,0.542,28,52,0.538,17,31,0.548,15,19,0.789,42,90,0.467,31,60,0.517,11,30,0.367,16,22,0.727
3/7/2017,9,OKC,POR,L ,121,126,240,44,85,0.518,34,60,0.567,10,25,0.4,23,30,0.767,47,85,0.553,36,62,0.581,11,23,0.478,21,27,0.778
3/7/2017,12,PHO,WAS,L ,127,131,240,44,88,0.5,31,61,0.508,13,27,0.481,26,33,0.788,41,90,0.456,34,72,0.472,7,18,0.389,42,53,0.792
3/6/2017,5,ATL,GSW,L ,111,119,240,38,82,0.463,25,54,0.463,13,28,0.464,22,31,0.71,41,87,0.471,21,43,0.488,20,44,0.455,17,22,0.773
3/6/2017,2,CHO,IND,W ,100,88,240,35,86,0.407,24,55,0.436,11,31,0.355,19,21,0.905,37,81,0.457,25,51,0.49,12,30,0.4,2,3,0.667
3/6/2017,1,CLE,MIA,L ,98,106,240,35,78,0.449,26,51,0.51,9,27,0.333,19,29,0.655,39,91,0.429,23,56,0.411,16,35,0.457,12,14,0.857
3/6/2017,0,DEN,SAC,W ,108,96,240,37,74,0.5,24,44,0.545,13,30,0.433,21,28,0.75,36,83,0.434,30,67,0.448,6,16,0.375,18,21,0.857
3/6/2017,4,DET,CHI,W ,109,95,240,45,92,0.489,39,71,0.549,6,21,0.286,13,20,0.65,34,83,0.41,26,55,0.473,8,28,0.286,19,21,0.905
3/6/2017,8,LAC,BOS,W ,116,102,240,39,73,0.534,30,53,0.566,9,20,0.45,29,47,0.617,34,83,0.41,24,48,0.5,10,35,0.286,24,29,0.828
3/6/2017,15,MEM,BRK,L ,109,122,240,34,77,0.442,24,52,0.462,10,25,0.4,31,39,0.795,39,73,0.534,25,43,0.581,14,30,0.467,30,38,0.789
3/6/2017,3,ORL,NYK,L ,105,113,240,40,85,0.471,31,53,0.585,9,32,0.281,16,24,0.667,40,86,0.465,34,72,0.472,6,14,0.429,27,28,0.964
3/6/2017,0,PHI,MIL,L ,98,112,240,39,89,0.438,31,59,0.525,8,30,0.267,12,19,0.632,41,83,0.494,27,50,0.54,14,33,0.424,16,20,0.8
3/6/2017,14,SAS,HOU,W ,112,110,240,40,88,0.455,29,60,0.483,11,28,0.393,21,23,0.913,41,88,0.466,27,49,0.551,14,39,0.359,14,17,0.824
3/6/2017,0,UTA,NOP,W ,88,83,240,33,81,0.407,23,54,0.426,10,27,0.37,12,15,0.8,30,84,0.357,20,51,0.392,10,33,0.303,13,18,0.722
3/5/2017,3,ATL,IND,L ,96,97,240,34,77,0.442,25,50,0.5,9,27,0.333,19,31,0.613,35,78,0.449,20,45,0.444,15,33,0.455,12,21,0.571
3/5/2017,3,DAL,OKC,W ,104,89,240,42,86,0.488,35,61,0.574,7,25,0.28,13,16,0.813,33,82,0.402,31,60,0.517,2,22,0.091,21,30,0.7
3/5/2017,13,LAL,NOP,L ,97,105,240,38,83,0.458,28,55,0.509,10,28,0.357,11,15,0.733,36,89,0.404,27,65,0.415,9,24,0.375,24,35,0.686
3/5/2017,12,NYK,GSW,L ,105,112,240,39,83,0.47,32,61,0.525,7,22,0.318,20,25,0.8,40,88,0.455,27,53,0.509,13,35,0.371,19,23,0.826
3/5/2017,9,PHO,BOS,W ,109,106,240,42,94,0.447,38,74,0.514,4,20,0.2,21,26,0.808,32,85,0.376,19,48,0.396,13,37,0.351,29,40,0.725
3/5/2017,9,SAC,UTA,L ,109,110,265,43,83,0.518,35,66,0.53,8,17,0.471,15,20,0.75,41,90,0.456,31,57,0.544,10,33,0.303,18,27,0.667
3/5/2017,7,WAS,ORL,W ,115,114,240,39,81,0.481,25,55,0.455,14,26,0.538,23,25,0.92,44,89,0.494,30,54,0.556,14,35,0.4,12,19,0.632
3/4/2017,6,CHI,LAC,L ,91,101,240,35,83,0.422,29,66,0.439,6,17,0.353,15,20,0.75,41,85,0.482,35,60,0.583,6,25,0.24,13,16,0.813
3/4/2017,1,DEN,CHO,L ,102,112,240,36,80,0.45,27,50,0.54,9,30,0.3,21,25,0.84,41,90,0.456,25,63,0.397,16,27,0.593,14,17,0.824
3/4/2017,3,HOU,MEM,W ,123,108,240,39,78,0.5,21,36,0.583,18,42,0.429,27,36,0.75,43,97,0.443,35,69,0.507,8,28,0.286,14,21,0.667
3/4/2017,3,MIA,CLE,W ,120,92,240,46,88,0.523,28,54,0.519,18,34,0.529,10,12,0.833,35,73,0.479,24,46,0.522,11,27,0.407,11,18,0.611
3/4/2017,1,MIL,TOR,W ,101,94,240,38,87,0.437,32,60,0.533,6,27,0.222,19,23,0.826,35,75,0.467,28,54,0.519,7,21,0.333,17,20,0.85
3/4/2017,5,PHI,DET,L ,106,136,240,43,88,0.489,29,54,0.537,14,34,0.412,6,7,0.857,54,95,0.568,44,72,0.611,10,23,0.435,18,21,0.857
3/4/2017,1,POR,BRK,W ,130,116,240,49,86,0.57,33,61,0.541,16,25,0.64,16,22,0.727,45,86,0.523,31,56,0.554,14,30,0.467,12,17,0.706
3/4/2017,5,SAS,MIN,W ,97,90,265,38,94,0.404,32,70,0.457,6,24,0.25,15,24,0.625,35,89,0.393,31,73,0.425,4,16,0.25,16,22,0.727
3/3/2017,0,ATL,CLE,L ,130,135,240,49,91,0.538,39,65,0.6,10,26,0.385,22,30,0.733,47,86,0.547,22,40,0.55,25,46,0.543,16,20,0.8
3/3/2017,16,DAL,MEM,W ,104,100,240,39,82,0.476,34,55,0.618,5,27,0.185,21,27,0.778,38,82,0.463,29,54,0.537,9,28,0.321,15,22,0.682
3/3/2017,3,LAL,BOS,L ,95,115,240,37,87,0.425,31,63,0.492,6,24,0.25,15,20,0.75,43,84,0.512,33,51,0.647,10,33,0.303,19,25,0.76
3/3/2017,3,MIL,LAC,W ,112,101,240,44,80,0.55,34,55,0.618,10,25,0.4,14,15,0.933,36,64,0.563,28,45,0.622,8,19,0.421,21,36,0.583
3/3/2017,11,NOP,SAS,L ,98,101,265,35,91,0.385,27,66,0.409,8,25,0.32,20,24,0.833,40,95,0.421,34,68,0.5,6,27,0.222,15,25,0.6
3/3/2017,1,ORL,MIA,W ,110,99,240,45,90,0.5,40,73,0.548,5,17,0.294,15,19,0.789,35,91,0.385,27,63,0.429,8,28,0.286,21,25,0.84
3/3/2017,9,PHI,NYK,W ,105,102,240,36,83,0.434,27,55,0.491,9,28,0.321,24,31,0.774,33,84,0.393,26,63,0.413,7,21,0.333,29,33,0.879
3/3/2017,3,PHO,OKC,W ,118,111,240,44,89,0.494,39,68,0.574,5,21,0.238,25,31,0.806,37,87,0.425,28,52,0.538,9,35,0.257,28,35,0.8
3/3/2017,0,UTA,BRK,W ,112,97,240,38,74,0.514,26,48,0.542,12,26,0.462,24,34,0.706,36,89,0.404,29,59,0.492,7,30,0.233,18,24,0.75
3/3/2017,9,WAS,TOR,L ,106,114,240,34,92,0.37,24,62,0.387,10,30,0.333,28,32,0.875,41,81,0.506,30,56,0.536,11,25,0.44,21,27,0.778
3/2/2017,8,CHI,GSW,W ,94,87,240,36,82,0.439,31,63,0.492,5,19,0.263,17,21,0.81,34,88,0.386,28,58,0.483,6,30,0.2,13,14,0.929
3/2/2017,5,PHO,CHO,W ,120,103,240,46,77,0.597,39,58,0.672,7,19,0.368,21,25,0.84,35,89,0.393,25,55,0.455,10,34,0.294,23,28,0.821
3/2/2017,12,POR,OKC,W ,114,109,240,39,79,0.494,29,54,0.537,10,25,0.4,26,35,0.743,34,86,0.395,23,57,0.404,11,29,0.379,30,32,0.938
3/1/2017,8,ATL,DAL,W ,100,95,240,36,64,0.563,26,43,0.605,10,21,0.476,18,24,0.75,35,77,0.455,21,44,0.477,14,33,0.424,11,13,0.846
3/1/2017,24,BOS,CLE,W ,103,99,240,36,78,0.462,23,47,0.489,13,31,0.419,18,23,0.783,37,91,0.407,27,58,0.466,10,33,0.303,15,22,0.682
3/1/2017,7,LAC,HOU,L ,103,122,240,42,94,0.447,30,60,0.5,12,34,0.353,7,13,0.538,37,87,0.425,17,35,0.486,20,52,0.385,28,33,0.848
3/1/2017,0,MIA,PHI,W ,125,98,240,49,90,0.544,36,60,0.6,13,30,0.433,14,21,0.667,37,85,0.435,31,68,0.456,6,17,0.353,18,22,0.818
3/1/2017,0,MIL,DEN,L ,98,110,240,38,83,0.458,29,65,0.446,9,18,0.5,13,15,0.867,41,84,0.488,31,51,0.608,10,33,0.303,18,20,0.9
3/1/2017,1,NOP,DET,W ,109,86,240,39,78,0.5,30,53,0.566,9,25,0.36,22,23,0.957,40,103,0.388,37,80,0.463,3,23,0.13,3,17,0.176
3/1/2017,3,ORL,NYK,L ,90,101,240,34,83,0.41,29,58,0.5,5,25,0.2,17,22,0.773,34,81,0.42,26,52,0.5,8,29,0.276,25,31,0.806
3/1/2017,0,SAC,BRK,L ,100,109,240,35,81,0.432,24,59,0.407,11,22,0.5,19,22,0.864,34,74,0.459,23,46,0.5,11,28,0.393,30,36,0.833
3/1/2017,16,SAS,IND,W ,100,99,240,35,74,0.473,26,45,0.578,9,29,0.31,21,24,0.875,37,81,0.457,30,58,0.517,7,23,0.304,18,25,0.72
3/1/2017,4,TOR,WAS,L ,96,105,240,33,90,0.367,26,70,0.371,7,20,0.35,23,26,0.885,40,84,0.476,31,59,0.525,9,25,0.36,16,19,0.842
3/1/2017,1,UTA,MIN,L ,80,107,240,35,90,0.389,31,71,0.437,4,19,0.211,6,11,0.545,39,78,0.5,31,62,0.5,8,16,0.5,21,26,0.808
2/28/2017,17,CHI,DEN,L ,107,125,240,44,96,0.458,34,70,0.486,10,26,0.385,9,10,0.9,45,80,0.563,32,50,0.64,13,30,0.433,22,24,0.917
2/28/2017,4,DET,POR,W ,120,113,265,45,104,0.433,38,79,0.481,7,25,0.28,23,31,0.742,44,84,0.524,34,59,0.576,10,25,0.4,15,22,0.682
2/28/2017,15,LAL,CHO,L ,104,109,240,41,84,0.488,29,52,0.558,12,32,0.375,10,13,0.769,38,85,0.447,22,46,0.478,16,39,0.41,17,24,0.708
2/28/2017,10,MEM,PHO,W ,130,112,240,48,86,0.558,36,61,0.59,12,25,0.48,22,29,0.759,43,83,0.518,36,62,0.581,7,21,0.333,19,24,0.792
2/28/2017,2,OKC,UTA,W ,109,106,240,39,76,0.513,24,54,0.444,15,22,0.682,16,23,0.696,43,93,0.462,34,71,0.479,9,22,0.409,11,13,0.846
2/28/2017,12,WAS,GSW,W ,112,108,240,41,91,0.451,29,63,0.46,12,28,0.429,18,20,0.9,39,84,0.464,31,55,0.564,8,29,0.276,22,27,0.815
2/27/2017,12,BOS,ATL,L ,98,114,240,34,87,0.391,24,53,0.453,10,34,0.294,20,25,0.8,46,95,0.484,40,70,0.571,6,25,0.24,16,20,0.8
2/27/2017,13,CLE,MIL,W ,102,95,240,35,70,0.5,25,42,0.595,10,28,0.357,22,26,0.846,37,83,0.446,26,53,0.491,11,30,0.367,10,16,0.625
2/27/2017,5,DAL,MIA,W ,96,89,240,33,76,0.434,24,58,0.414,9,18,0.5,21,23,0.913,37,83,0.446,28,57,0.491,9,26,0.346,6,13,0.462
2/27/2017,7,HOU,IND,L ,108,117,240,32,88,0.364,22,43,0.512,10,45,0.222,34,42,0.81,41,91,0.451,28,61,0.459,13,30,0.433,22,25,0.88
2/27/2017,15,NYK,TOR,L ,91,92,240,33,73,0.452,24,49,0.49,9,24,0.375,16,19,0.842,33,78,0.423,26,52,0.5,7,26,0.269,19,23,0.826
2/27/2017,4,PHI,GSW,L ,108,119,240,37,82,0.451,27,48,0.563,10,34,0.294,24,27,0.889,40,89,0.449,34,60,0.567,6,29,0.207,33,39,0.846
2/27/2017,2,SAC,MIN,L ,88,102,240,36,82,0.439,30,65,0.462,6,17,0.353,10,15,0.667,40,95,0.421,32,72,0.444,8,23,0.348,14,20,0.7
2/26/2017,14,DEN,MEM,L ,98,105,240,37,84,0.44,26,50,0.52,11,34,0.324,13,17,0.765,36,80,0.45,25,47,0.532,11,33,0.333,22,25,0.88
2/26/2017,11,DET,BOS,L ,98,104,240,35,81,0.432,23,48,0.479,12,33,0.364,16,35,0.457,34,85,0.4,22,50,0.44,12,35,0.343,24,30,0.8
2/26/2017,16,LAC,CHO,W ,124,121,265,45,97,0.464,35,65,0.538,10,32,0.313,24,34,0.706,38,80,0.475,20,40,0.5,18,40,0.45,27,30,0.9
2/26/2017,2,LAL,SAS,L ,98,119,240,40,87,0.46,33,65,0.508,7,22,0.318,11,18,0.611,49,94,0.521,39,73,0.534,10,21,0.476,11,13,0.846
2/26/2017,8,MIL,PHO,W ,100,96,240,39,76,0.513,33,56,0.589,6,20,0.3,16,18,0.889,40,83,0.482,35,69,0.507,5,14,0.357,11,16,0.688
2/26/2017,20,OKC,NOP,W ,118,110,240,42,88,0.477,36,67,0.537,6,21,0.286,28,37,0.757,36,80,0.45,28,59,0.475,8,21,0.381,30,37,0.811
2/26/2017,14,TOR,POR,W ,112,106,240,42,78,0.538,35,58,0.603,7,20,0.35,21,27,0.778,35,79,0.443,26,58,0.448,9,21,0.429,27,35,0.771
2/26/2017,4,WAS,UTA,L ,92,102,240,37,87,0.425,29,65,0.446,8,22,0.364,10,13,0.769,34,72,0.472,23,48,0.479,11,24,0.458,23,32,0.719
2/25/2017,13,CLE,CHI,L ,99,117,240,37,80,0.463,23,43,0.535,14,37,0.378,11,15,0.733,46,93,0.495,31,63,0.492,15,30,0.5,10,16,0.625
2/25/2017,5,DAL,NOP,W ,96,83,240,36,78,0.462,24,52,0.462,12,26,0.462,12,16,0.75,31,78,0.397,26,54,0.481,5,24,0.208,16,25,0.64
2/25/2017,2,GSW,BRK,W ,112,95,240,42,100,0.42,31,69,0.449,11,31,0.355,17,22,0.773,38,94,0.404,30,66,0.455,8,28,0.286,11,17,0.647
2/25/2017,0,HOU,MIN,W ,142,130,240,44,94,0.468,22,36,0.611,22,58,0.379,32,42,0.762,49,94,0.521,40,68,0.588,9,26,0.346,23,28,0.821
2/25/2017,9,MIA,IND,W ,113,95,240,38,78,0.487,25,47,0.532,13,31,0.419,24,31,0.774,34,85,0.4,30,73,0.411,4,12,0.333,23,26,0.885
2/25/2017,6,NYK,PHI,W ,110,109,240,43,91,0.473,37,70,0.529,6,21,0.286,18,23,0.783,40,95,0.421,33,64,0.516,7,31,0.226,22,27,0.815
2/25/2017,6,ORL,ATL,W ,105,86,240,37,81,0.457,29,54,0.537,8,27,0.296,23,24,0.958,32,85,0.376,24,60,0.4,8,25,0.32,14,26,0.538
2/25/2017,2,SAC,CHO,L ,85,99,240,31,79,0.392,20,51,0.392,11,28,0.393,12,15,0.8,34,85,0.4,20,47,0.426,14,38,0.368,17,18,0.944
2/24/2017,9,ATL,MIA,L ,90,108,240,30,79,0.38,24,59,0.407,6,20,0.3,24,36,0.667,40,99,0.404,23,62,0.371,17,37,0.459,11,13,0.846
2/24/2017,13,CHI,PHO,W ,128,121,265,46,98,0.469,34,72,0.472,12,26,0.462,24,31,0.774,49,93,0.527,41,69,0.594,8,24,0.333,15,25,0.6
2/24/2017,1,DEN,BRK,W ,129,109,240,49,97,0.505,35,66,0.53,14,31,0.452,17,24,0.708,41,83,0.494,31,53,0.585,10,30,0.333,17,31,0.548
2/24/2017,9,IND,MEM,W ,102,92,240,40,78,0.513,29,52,0.558,11,26,0.423,11,11,1,35,84,0.417,26,57,0.456,9,27,0.333,13,23,0.565
2/24/2017,9,LAC,SAS,L ,97,105,240,35,79,0.443,28,56,0.5,7,23,0.304,20,24,0.833,35,82,0.427,26,56,0.464,9,26,0.346,26,30,0.867
2/24/2017,2,MIL,UTA,L ,95,109,240,32,74,0.432,25,56,0.446,7,18,0.389,24,29,0.828,37,74,0.5,29,51,0.569,8,23,0.348,27,30,0.9
2/24/2017,2,MIN,DAL,W ,97,84,240,41,78,0.526,36,65,0.554,5,13,0.385,10,14,0.714,35,83,0.422,27,50,0.54,8,33,0.242,6,9,0.667
2/24/2017,3,OKC,LAL,W ,110,93,240,44,97,0.454,34,73,0.466,10,24,0.417,12,17,0.706,40,101,0.396,33,66,0.5,7,35,0.2,6,14,0.429
2/24/2017,7,PHI,WAS,W ,120,112,240,43,87,0.494,33,58,0.569,10,29,0.345,24,30,0.8,38,90,0.422,33,66,0.5,5,24,0.208,31,40,0.775
2/24/2017,4,TOR,BOS,W ,107,97,240,40,81,0.494,35,66,0.53,5,15,0.333,22,29,0.759,33,78,0.423,21,40,0.525,12,38,0.316,19,22,0.864
2/23/2017,8,CLE,NYK,W ,119,104,240,46,87,0.529,31,49,0.633,15,38,0.395,12,15,0.8,42,101,0.416,34,75,0.453,8,26,0.308,12,17,0.706
2/23/2017,5,DET,CHO,W ,114,108,265,44,107,0.411,29,70,0.414,15,37,0.405,11,12,0.917,38,92,0.413,31,62,0.5,7,30,0.233,25,26,0.962
2/23/2017,5,GSW,LAC,W ,123,113,240,43,81,0.531,30,56,0.536,13,25,0.52,24,26,0.923,38,93,0.409,27,65,0.415,11,28,0.393,26,37,0.703
2/23/2017,3,NOP,HOU,L ,99,129,240,36,86,0.419,30,55,0.545,6,31,0.194,21,26,0.808,45,91,0.495,25,40,0.625,20,51,0.392,19,24,0.792
2/23/2017,8,ORL,POR,L ,103,112,240,34,86,0.395,27,64,0.422,7,22,0.318,28,39,0.718,41,81,0.506,32,63,0.508,9,18,0.5,21,27,0.778
2/23/2017,4,SAC,DEN,W ,116,100,240,46,88,0.523,39,74,0.527,7,14,0.5,17,19,0.895,39,88,0.443,27,53,0.509,12,35,0.343,10,14,0.714
2/16/2017,14,CHI,BOS,W ,104,103,240,38,90,0.422,32,65,0.492,6,25,0.24,22,22,1,36,77,0.468,22,40,0.55,14,37,0.378,17,20,0.85
2/16/2017,0,IND,WAS,L ,98,111,240,40,80,0.5,36,62,0.581,4,18,0.222,14,18,0.778,43,83,0.518,28,54,0.519,15,29,0.517,10,15,0.667
2/15/2017,11,BOS,PHI,W ,116,108,240,38,80,0.475,25,52,0.481,13,28,0.464,27,36,0.75,44,93,0.473,36,62,0.581,8,31,0.258,12,18,0.667
2/15/2017,6,BRK,MIL,L ,125,129,240,46,88,0.523,32,52,0.615,14,36,0.389,19,23,0.826,50,88,0.568,43,73,0.589,7,15,0.467,22,32,0.688
2/15/2017,2,CLE,IND,W ,113,104,240,39,82,0.476,21,43,0.488,18,39,0.462,17,19,0.895,40,86,0.465,28,62,0.452,12,24,0.5,12,14,0.857
2/15/2017,10,DEN,MIN,L ,99,112,240,38,94,0.404,27,60,0.45,11,34,0.324,12,18,0.667,41,86,0.477,35,68,0.515,6,18,0.333,24,28,0.857
2/15/2017,0,DET,DAL,W ,98,91,240,36,82,0.439,30,63,0.476,6,19,0.316,20,22,0.909,35,92,0.38,25,55,0.455,10,37,0.27,11,11,1
2/15/2017,7,GSW,SAC,W ,109,86,240,41,84,0.488,28,48,0.583,13,36,0.361,14,21,0.667,33,89,0.371,26,65,0.4,7,24,0.292,13,17,0.765
2/15/2017,0,HOU,MIA,L ,109,117,240,36,87,0.414,23,47,0.489,13,40,0.325,24,31,0.774,44,84,0.524,31,49,0.633,13,35,0.371,16,24,0.667
2/15/2017,8,LAC,ATL,W ,99,84,240,37,79,0.468,23,42,0.548,14,37,0.378,11,12,0.917,32,79,0.405,25,53,0.472,7,26,0.269,13,19,0.684
2/15/2017,1,MEM,NOP,L ,91,95,240,33,89,0.371,27,56,0.482,6,33,0.182,19,25,0.76,37,75,0.493,29,57,0.509,8,18,0.444,13,22,0.591
2/15/2017,1,OKC,NYK,W ,116,105,240,41,88,0.466,29,65,0.446,12,23,0.522,22,31,0.71,41,86,0.477,30,65,0.462,11,21,0.524,12,14,0.857
2/15/2017,0,ORL,SAS,L ,79,107,240,30,76,0.395,26,58,0.448,4,18,0.222,15,19,0.789,42,89,0.472,34,58,0.586,8,31,0.258,15,19,0.789
2/15/2017,0,PHO,LAL,W ,137,101,240,49,88,0.557,39,64,0.609,10,24,0.417,29,34,0.853,35,93,0.376,26,67,0.388,9,26,0.346,22,28,0.786
2/15/2017,4,TOR,CHO,W ,90,85,240,32,84,0.381,20,52,0.385,12,32,0.375,14,19,0.737,32,76,0.421,19,38,0.5,13,38,0.342,8,9,0.889
2/15/2017,7,UTA,POR,W ,111,88,240,42,81,0.519,31,59,0.525,11,22,0.5,16,23,0.696,32,79,0.405,23,57,0.404,9,22,0.409,15,20,0.75
2/14/2017,7,CHI,TOR,W ,105,94,240,35,73,0.479,28,56,0.5,7,17,0.412,28,35,0.8,35,77,0.455,30,57,0.526,5,20,0.25,19,24,0.792
2/14/2017,8,LAL,SAC,L ,96,97,240,38,83,0.458,26,54,0.481,12,29,0.414,8,15,0.533,36,73,0.493,29,49,0.592,7,24,0.292,18,25,0.72
2/14/2017,7,MIN,CLE,L ,108,116,240,42,86,0.488,33,63,0.524,9,23,0.391,15,19,0.789,44,86,0.512,31,47,0.66,13,39,0.333,15,22,0.682
2/13/2017,9,BRK,MEM,L ,103,112,240,38,82,0.463,26,45,0.578,12,37,0.324,15,18,0.833,39,77,0.506,30,55,0.545,9,22,0.409,25,27,0.926
2/13/2017,10,CHO,PHI,L ,99,105,240,34,78,0.436,23,47,0.489,11,31,0.355,20,26,0.769,41,86,0.477,29,53,0.547,12,33,0.364,11,17,0.647
2/13/2017,10,DAL,BOS,L ,98,111,240,35,77,0.455,26,50,0.52,9,27,0.333,19,25,0.76,40,81,0.494,24,47,0.511,16,34,0.471,15,18,0.833
2/13/2017,5,DEN,GSW,W ,132,110,240,48,88,0.545,24,47,0.511,24,41,0.585,12,16,0.75,45,92,0.489,37,60,0.617,8,32,0.25,12,13,0.923
2/13/2017,14,IND,SAS,L ,106,110,240,38,78,0.487,29,58,0.5,9,20,0.45,21,30,0.7,40,87,0.46,33,72,0.458,7,15,0.467,23,27,0.852
2/13/2017,3,MIA,ORL,L ,107,116,240,39,83,0.47,33,61,0.541,6,22,0.273,23,27,0.852,44,90,0.489,36,76,0.474,8,14,0.571,20,29,0.69
2/13/2017,2,MIL,DET,W ,102,89,240,40,79,0.506,34,58,0.586,6,21,0.286,16,16,1,34,78,0.436,27,57,0.474,7,21,0.333,14,19,0.737
2/13/2017,28,PHO,NOP,L ,108,110,240,40,93,0.43,32,70,0.457,8,23,0.348,20,24,0.833,37,78,0.474,29,50,0.58,8,28,0.286,28,35,0.8
2/13/2017,17,POR,ATL,L ,104,109,265,37,103,0.359,21,61,0.344,16,42,0.381,14,25,0.56,32,83,0.386,24,55,0.436,8,28,0.286,37,48,0.771
2/13/2017,4,UTA,LAC,L ,72,88,240,28,87,0.322,24,64,0.375,4,23,0.174,12,18,0.667,36,81,0.444,27,56,0.482,9,25,0.36,7,11,0.636
2/13/2017,0,WAS,OKC,W ,120,98,240,42,73,0.575,29,53,0.547,13,20,0.65,23,28,0.821,34,96,0.354,27,62,0.435,7,34,0.206,23,30,0.767
2/12/2017,1,MIN,CHI,W ,117,89,240,44,81,0.543,38,57,0.667,6,24,0.25,23,26,0.885,35,84,0.417,25,59,0.424,10,25,0.4,9,13,0.692
2/12/2017,6,NYK,SAS,W ,94,90,240,34,68,0.5,25,54,0.463,9,14,0.643,17,21,0.81,33,91,0.363,27,62,0.435,6,29,0.207,18,22,0.818
2/12/2017,6,SAC,NOP,W ,105,99,240,35,78,0.449,24,47,0.511,11,31,0.355,24,27,0.889,34,82,0.415,21,51,0.412,13,31,0.419,18,21,0.857
2/12/2017,8,TOR,DET,L ,101,102,240,38,75,0.507,30,59,0.508,8,16,0.5,17,25,0.68,36,84,0.429,28,53,0.528,8,31,0.258,22,29,0.759
2/11/2017,3,CHO,LAC,L ,102,107,240,37,85,0.435,24,48,0.5,13,37,0.351,15,20,0.75,40,85,0.471,26,51,0.51,14,34,0.412,13,20,0.65
2/11/2017,5,CLE,DEN,W ,125,109,240,46,84,0.548,31,54,0.574,15,30,0.5,18,22,0.818,39,97,0.402,27,60,0.45,12,37,0.324,19,22,0.864
2/11/2017,1,DAL,ORL,W ,112,80,240,45,91,0.495,28,56,0.5,17,35,0.486,5,6,0.833,32,82,0.39,29,59,0.492,3,23,0.13,13,18,0.722
2/11/2017,0,HOU,PHO,W ,133,102,240,42,85,0.494,24,49,0.49,18,36,0.5,31,39,0.795,37,94,0.394,29,72,0.403,8,22,0.364,20,26,0.769
2/11/2017,1,IND,MIL,L ,100,116,240,35,73,0.479,25,51,0.49,10,22,0.455,20,24,0.833,35,73,0.479,18,42,0.429,17,31,0.548,29,37,0.784
2/11/2017,1,OKC,GSW,L ,114,130,240,40,83,0.482,34,59,0.576,6,24,0.25,28,36,0.778,46,87,0.529,33,56,0.589,13,31,0.419,25,35,0.714
2/11/2017,4,PHI,MIA,W ,117,109,240,39,86,0.453,30,61,0.492,9,25,0.36,30,38,0.789,39,85,0.459,32,61,0.525,7,24,0.292,24,28,0.857
2/11/2017,0,UTA,BOS,L ,104,112,240,35,86,0.407,27,55,0.491,8,31,0.258,26,30,0.867,42,71,0.592,29,41,0.707,13,30,0.433,15,23,0.652
2/10/2017,4,BRK,MIA,L ,99,108,240,35,81,0.432,27,61,0.443,8,20,0.4,21,28,0.75,41,92,0.446,34,69,0.493,7,23,0.304,19,21,0.905
2/10/2017,0,DET,SAS,L ,92,103,240,39,92,0.424,34,75,0.453,5,17,0.294,9,13,0.692,41,82,0.5,32,63,0.508,9,19,0.474,12,15,0.8
2/10/2017,0,MEM,GSW,L ,107,122,240,34,87,0.391,25,61,0.41,9,26,0.346,30,37,0.811,39,77,0.506,24,44,0.545,15,33,0.455,29,38,0.763
2/10/2017,4,MIL,LAL,L ,114,122,240,40,76,0.526,32,48,0.667,8,28,0.286,26,31,0.839,39,75,0.52,24,44,0.545,15,31,0.484,29,35,0.829
2/10/2017,16,MIN,NOP,L ,106,122,240,38,82,0.463,32,55,0.582,6,27,0.222,24,32,0.75,45,75,0.6,33,50,0.66,12,25,0.48,20,27,0.741
2/10/2017,8,NYK,DEN,L ,123,131,240,52,93,0.559,36,55,0.655,16,38,0.421,3,5,0.6,54,95,0.568,38,63,0.603,16,32,0.5,7,10,0.7
2/10/2017,6,PHO,CHI,W ,115,97,240,48,95,0.505,40,76,0.526,8,19,0.421,11,13,0.846,37,86,0.43,32,67,0.478,5,19,0.263,18,22,0.818
2/10/2017,7,SAC,ATL,W ,108,107,240,38,80,0.475,20,44,0.455,18,36,0.5,14,21,0.667,36,71,0.507,25,41,0.61,11,30,0.367,24,31,0.774
2/10/2017,6,WAS,IND,W ,112,107,240,41,88,0.466,31,59,0.525,10,29,0.345,20,30,0.667,45,92,0.489,41,71,0.577,4,21,0.19,13,15,0.867
2/9/2017,3,CHO,HOU,L ,95,107,240,37,85,0.435,29,59,0.492,8,26,0.308,13,14,0.929,39,87,0.448,26,47,0.553,13,40,0.325,16,20,0.8
2/9/2017,6,DAL,UTA,W ,112,105,265,44,87,0.506,39,67,0.582,5,20,0.25,19,25,0.76,39,85,0.459,26,56,0.464,13,29,0.448,14,17,0.824
2/9/2017,7,OKC,CLE,W ,118,109,240,50,106,0.472,42,79,0.532,8,27,0.296,10,13,0.769,38,79,0.481,28,58,0.483,10,21,0.476,23,30,0.767
2/9/2017,10,ORL,PHI,L ,111,112,240,41,84,0.488,31,63,0.492,10,21,0.476,19,24,0.792,40,95,0.421,29,67,0.433,11,28,0.393,21,27,0.778
2/9/2017,10,POR,BOS,L ,111,120,240,39,77,0.506,30,51,0.588,9,26,0.346,24,31,0.774,44,91,0.484,34,61,0.557,10,30,0.333,22,27,0.815
2/8/2017,0,ATL,DEN,W ,117,106,240,47,93,0.505,39,66,0.591,8,27,0.296,15,18,0.833,40,100,0.4,27,56,0.482,13,44,0.295,13,21,0.619
2/8/2017,9,BRK,WAS,L ,110,114,265,38,91,0.418,29,58,0.5,9,33,0.273,25,36,0.694,40,97,0.412,31,72,0.431,9,25,0.36,25,33,0.758
2/8/2017,8,DET,LAL,W ,121,102,240,51,97,0.526,47,81,0.58,4,16,0.25,15,24,0.625,37,86,0.43,31,63,0.492,6,23,0.261,22,26,0.846
2/8/2017,0,GSW,CHI,W ,123,92,240,48,85,0.565,33,57,0.579,15,28,0.536,12,13,0.923,37,92,0.402,33,68,0.485,4,24,0.167,14,19,0.737
2/8/2017,5,IND,CLE,L ,117,132,240,41,82,0.5,28,57,0.491,13,25,0.52,22,26,0.846,46,84,0.548,30,48,0.625,16,36,0.444,24,26,0.923
2/8/2017,3,MEM,PHO,W ,110,91,240,35,72,0.486,21,48,0.438,14,24,0.583,26,34,0.765,29,87,0.333,24,64,0.375,5,23,0.217,28,34,0.824
2/8/2017,0,MIL,MIA,L ,88,106,240,33,71,0.465,27,56,0.482,6,15,0.4,16,28,0.571,41,86,0.477,30,53,0.566,11,33,0.333,13,18,0.722
2/8/2017,5,MIN,TOR,W ,112,109,240,39,80,0.488,32,61,0.525,7,19,0.368,27,30,0.9,42,79,0.532,31,51,0.608,11,28,0.393,14,20,0.7
2/8/2017,5,NOP,UTA,L ,94,127,240,35,77,0.455,30,53,0.566,5,24,0.208,19,25,0.76,48,88,0.545,34,56,0.607,14,32,0.438,17,21,0.81
2/8/2017,16,NYK,LAC,L ,115,119,240,46,92,0.5,38,65,0.585,8,27,0.296,15,18,0.833,45,92,0.489,35,67,0.522,10,25,0.4,19,28,0.679
2/8/2017,0,PHI,SAS,L ,103,111,240,34,84,0.405,21,50,0.42,13,34,0.382,22,29,0.759,39,74,0.527,28,52,0.538,11,22,0.5,22,25,0.88
2/8/2017,5,SAC,BOS,W ,108,92,240,42,84,0.5,32,59,0.542,10,25,0.4,14,15,0.933,29,73,0.397,19,41,0.463,10,32,0.313,24,27,0.889
2/7/2017,1,CHO,BRK,W ,111,107,240,40,102,0.392,33,76,0.434,7,26,0.269,24,29,0.828,39,86,0.453,27,50,0.54,12,36,0.333,17,21,0.81
2/7/2017,13,DAL,POR,L ,113,114,240,37,75,0.493,25,47,0.532,12,28,0.429,27,32,0.844,42,86,0.488,31,58,0.534,11,28,0.393,19,24,0.792
2/7/2017,9,HOU,ORL,W ,128,104,240,44,89,0.494,28,51,0.549,16,38,0.421,24,36,0.667,42,88,0.477,36,63,0.571,6,25,0.24,14,20,0.7
2/6/2017,0,ATL,UTA,L ,95,120,240,33,74,0.446,27,57,0.474,6,17,0.353,23,32,0.719,49,80,0.613,39,54,0.722,10,26,0.385,12,18,0.667
2/6/2017,1,DEN,DAL,W ,110,87,240,42,84,0.5,31,56,0.554,11,28,0.393,15,16,0.938,34,79,0.43,26,53,0.491,8,26,0.308,11,17,0.647
2/6/2017,2,DET,PHI,W ,113,96,240,46,99,0.465,41,77,0.532,5,22,0.227,16,17,0.941,36,85,0.424,31,57,0.544,5,28,0.179,19,28,0.679
2/6/2017,8,IND,OKC,W ,93,90,240,33,87,0.379,25,61,0.41,8,26,0.308,19,29,0.655,34,88,0.386,27,60,0.45,7,28,0.25,15,21,0.714
2/6/2017,14,MEM,SAS,W ,89,74,240,32,81,0.395,28,62,0.452,4,19,0.211,21,25,0.84,30,82,0.366,26,63,0.413,4,19,0.211,10,18,0.556
2/6/2017,0,MIN,MIA,L ,113,115,240,43,80,0.538,38,69,0.551,5,11,0.455,22,28,0.786,45,86,0.523,30,58,0.517,15,28,0.536,10,14,0.714
2/6/2017,13,NOP,PHO,W ,111,106,240,42,92,0.457,33,66,0.5,9,26,0.346,18,22,0.818,40,93,0.43,35,66,0.53,5,27,0.185,21,25,0.84
2/6/2017,1,NYK,LAL,L ,107,121,240,37,82,0.451,30,61,0.492,7,21,0.333,26,33,0.788,44,102,0.431,36,74,0.486,8,28,0.286,25,31,0.806
2/6/2017,0,SAC,CHI,L ,107,112,240,41,79,0.519,30,51,0.588,11,28,0.393,14,16,0.875,43,81,0.531,37,62,0.597,6,19,0.316,20,31,0.645
2/6/2017,5,TOR,LAC,W ,118,109,240,41,84,0.488,31,60,0.517,10,24,0.417,26,29,0.897,42,90,0.467,29,55,0.527,13,35,0.371,12,18,0.667
2/6/2017,16,WAS,CLE,L ,135,140,265,50,99,0.505,38,70,0.543,12,29,0.414,23,26,0.885,49,92,0.533,30,54,0.556,19,38,0.5,23,28,0.821
2/5/2017,0,BOS,LAC,W ,107,102,240,37,88,0.42,21,36,0.583,16,52,0.308,17,20,0.85,35,84,0.417,25,55,0.455,10,29,0.345,22,28,0.786
2/5/2017,9,BRK,TOR,L ,95,103,240,32,76,0.421,19,42,0.452,13,34,0.382,18,21,0.857,40,87,0.46,35,68,0.515,5,19,0.263,18,20,0.9
2/5/2017,16,OKC,POR,W ,105,99,240,40,98,0.408,36,80,0.45,4,18,0.222,21,28,0.75,35,87,0.402,25,59,0.424,10,28,0.357,19,21,0.905
2/4/2017,0,ATL,ORL,W ,113,86,240,41,78,0.526,31,50,0.62,10,28,0.357,21,27,0.778,27,78,0.346,20,51,0.392,7,27,0.259,25,28,0.893
2/4/2017,11,IND,DET,W ,105,84,240,44,91,0.484,37,67,0.552,7,24,0.292,10,15,0.667,31,75,0.413,25,58,0.431,6,17,0.353,16,20,0.8
2/4/2017,1,MIA,PHI,W ,125,102,240,48,82,0.585,36,60,0.6,12,22,0.545,17,23,0.739,35,84,0.417,29,61,0.475,6,23,0.261,26,31,0.839
2/4/2017,6,MIN,MEM,L ,99,107,240,35,84,0.417,25,58,0.431,10,26,0.385,19,24,0.792,32,77,0.416,22,49,0.449,10,28,0.357,33,39,0.846
2/4/2017,9,NYK,CLE,L ,104,111,240,39,86,0.453,27,55,0.491,12,31,0.387,14,28,0.5,41,84,0.488,25,44,0.568,16,40,0.4,13,18,0.722
2/4/2017,1,PHO,MIL,L ,112,137,240,38,91,0.418,27,63,0.429,11,28,0.393,25,30,0.833,52,82,0.634,45,65,0.692,7,17,0.412,26,35,0.743
2/4/2017,14,SAC,GSW,W ,109,106,265,43,88,0.489,36,65,0.554,7,23,0.304,16,19,0.842,36,87,0.414,21,43,0.488,15,44,0.341,19,24,0.792
2/4/2017,4,SAS,DEN,W ,121,97,240,45,79,0.57,35,58,0.603,10,21,0.476,21,26,0.808,41,92,0.446,31,66,0.47,10,26,0.385,5,10,0.5
2/4/2017,11,UTA,CHO,W ,105,98,240,38,81,0.469,25,48,0.521,13,33,0.394,16,24,0.667,35,82,0.427,22,49,0.449,13,33,0.394,15,18,0.833
2/4/2017,11,WAS,NOP,W ,105,91,240,38,83,0.458,28,52,0.538,10,31,0.323,19,22,0.864,37,84,0.44,32,67,0.478,5,17,0.294,12,22,0.545
2/3/2017,6,BOS,LAL,W ,113,107,240,39,82,0.476,26,47,0.553,13,35,0.371,22,28,0.786,37,94,0.394,23,56,0.411,14,38,0.368,19,26,0.731
2/3/2017,2,BRK,IND,L ,97,106,240,32,86,0.372,21,58,0.362,11,28,0.393,22,23,0.957,37,86,0.43,29,66,0.439,8,20,0.4,24,31,0.774
2/3/2017,3,DEN,MIL,W ,121,117,240,40,89,0.449,31,61,0.508,9,28,0.321,32,44,0.727,45,83,0.542,36,59,0.61,9,24,0.375,18,23,0.783
2/3/2017,10,DET,MIN,W ,116,108,240,44,98,0.449,33,72,0.458,11,26,0.423,17,22,0.773,44,89,0.494,39,72,0.542,5,17,0.294,15,19,0.789
2/3/2017,21,HOU,CHI,W ,121,117,265,44,98,0.449,28,55,0.509,16,43,0.372,17,25,0.68,48,100,0.48,40,75,0.533,8,25,0.32,13,18,0.722
2/3/2017,10,OKC,MEM,W ,114,102,240,38,80,0.475,25,54,0.463,13,26,0.5,25,33,0.758,40,83,0.482,37,64,0.578,3,19,0.158,19,22,0.864
2/3/2017,9,ORL,TOR,W ,102,94,240,37,80,0.463,32,66,0.485,5,14,0.357,23,32,0.719,34,87,0.391,24,59,0.407,10,28,0.357,16,21,0.762
2/3/2017,0,POR,DAL,L ,104,108,240,40,88,0.455,31,58,0.534,9,30,0.3,15,20,0.75,36,76,0.474,19,45,0.422,17,31,0.548,19,23,0.826
2/3/2017,10,SAC,PHO,L ,103,105,240,38,85,0.447,28,58,0.483,10,27,0.37,17,22,0.773,32,77,0.416,20,48,0.417,12,29,0.414,29,35,0.829
2/2/2017,14,HOU,ATL,L ,108,113,240,35,93,0.376,22,42,0.524,13,51,0.255,25,33,0.758,44,85,0.518,36,55,0.655,8,30,0.267,17,23,0.739
2/2/2017,0,LAC,GSW,L ,120,133,240,40,80,0.5,30,55,0.545,10,25,0.4,30,39,0.769,52,99,0.525,38,65,0.585,14,34,0.412,15,18,0.833
2/2/2017,4,SAS,PHI,W ,102,86,240,38,89,0.427,32,68,0.471,6,21,0.286,20,27,0.741,30,88,0.341,21,63,0.333,9,25,0.36,17,23,0.739
2/2/2017,1,WAS,LAL,W ,116,108,240,44,96,0.458,32,63,0.508,12,33,0.364,16,21,0.762,40,87,0.46,28,48,0.583,12,39,0.308,16,22,0.727
2/1/2017,7,BOS,TOR,W ,109,104,240,36,87,0.414,24,51,0.471,12,36,0.333,25,30,0.833,41,78,0.526,33,47,0.702,8,31,0.258,14,25,0.56
2/1/2017,1,BRK,NYK,L ,90,95,240,37,88,0.42,32,63,0.508,5,25,0.2,11,16,0.688,35,99,0.354,29,72,0.403,6,27,0.222,19,31,0.613
2/1/2017,1,CLE,MIN,W ,125,97,240,48,89,0.539,33,52,0.635,15,37,0.405,14,22,0.636,41,94,0.436,34,73,0.466,7,21,0.333,8,10,0.8
2/1/2017,6,DAL,PHI,W ,113,95,240,40,86,0.465,30,60,0.5,10,26,0.385,23,28,0.821,35,77,0.455,29,55,0.527,6,22,0.273,19,26,0.731
2/1/2017,6,DEN,MEM,L ,99,119,240,32,80,0.4,23,55,0.418,9,25,0.36,26,35,0.743,45,92,0.489,31,62,0.5,14,30,0.467,15,20,0.75
2/1/2017,19,DET,NOP,W ,118,98,240,48,88,0.545,38,62,0.613,10,26,0.385,12,17,0.706,41,82,0.5,36,61,0.59,5,21,0.238,11,14,0.786
2/1/2017,0,GSW,CHO,W ,126,111,240,47,96,0.49,26,48,0.542,21,48,0.438,11,14,0.786,39,88,0.443,30,57,0.526,9,31,0.29,24,26,0.923
2/1/2017,1,MIA,ATL,W ,116,93,240,45,93,0.484,33,61,0.541,12,32,0.375,14,19,0.737,34,86,0.395,27,60,0.45,7,26,0.269,18,21,0.857
2/1/2017,17,OKC,CHI,L ,100,128,240,38,100,0.38,28,63,0.444,10,37,0.27,14,17,0.824,49,81,0.605,43,66,0.652,6,15,0.4,24,30,0.8
2/1/2017,3,ORL,IND,L ,88,98,240,31,77,0.403,25,53,0.472,6,24,0.25,20,28,0.714,33,69,0.478,24,49,0.49,9,20,0.45,23,26,0.885
2/1/2017,0,PHO,LAC,L ,114,124,240,39,96,0.406,32,76,0.421,7,20,0.35,29,35,0.829,44,85,0.518,39,66,0.591,5,19,0.263,31,38,0.816
2/1/2017,12,UTA,MIL,W ,104,88,240,36,78,0.462,25,49,0.51,11,29,0.379,21,27,0.778,32,73,0.438,23,50,0.46,9,23,0.391,15,25,0.6
1/31/2017,10,HOU,SAC,W ,105,83,240,38,85,0.447,24,40,0.6,14,45,0.311,15,22,0.682,30,86,0.349,22,57,0.386,8,29,0.276,15,26,0.577
1/31/2017,22,LAL,DEN,W ,120,116,240,47,89,0.528,35,63,0.556,12,26,0.462,14,18,0.778,41,99,0.414,26,72,0.361,15,27,0.556,19,23,0.826
1/31/2017,7,POR,CHO,W ,115,98,240,42,93,0.452,31,62,0.5,11,31,0.355,20,23,0.87,33,83,0.398,22,52,0.423,11,31,0.355,21,25,0.84
1/31/2017,3,SAS,OKC,W ,108,94,240,37,86,0.43,30,65,0.462,7,21,0.333,27,38,0.711,30,85,0.353,23,57,0.404,7,28,0.25,27,32,0.844
1/31/2017,21,TOR,NOP,W ,108,106,265,43,94,0.457,33,63,0.524,10,31,0.323,12,15,0.8,40,94,0.426,28,64,0.438,12,30,0.4,14,19,0.737
1/31/2017,5,WAS,NYK,W ,117,101,240,49,88,0.557,42,66,0.636,7,22,0.318,12,15,0.8,34,93,0.366,29,69,0.42,5,24,0.208,28,35,0.8
1/30/2017,10,BOS,DET,W ,113,109,240,36,82,0.439,23,50,0.46,13,32,0.406,28,33,0.848,43,97,0.443,40,70,0.571,3,27,0.111,20,29,0.69
1/30/2017,3,DAL,CLE,W ,104,97,240,39,86,0.453,30,54,0.556,9,32,0.281,17,18,0.944,35,75,0.467,23,43,0.535,12,32,0.375,15,21,0.714
1/30/2017,3,MIA,BRK,W ,104,96,240,39,82,0.476,28,56,0.5,11,26,0.423,15,23,0.652,37,87,0.425,33,61,0.541,4,26,0.154,18,22,0.818
1/30/2017,7,MIN,ORL,W ,111,105,265,40,91,0.44,28,62,0.452,12,29,0.414,19,26,0.731,41,96,0.427,31,61,0.508,10,35,0.286,13,19,0.684
1/30/2017,3,PHI,SAC,W ,122,119,240,45,83,0.542,34,52,0.654,11,31,0.355,21,26,0.808,41,74,0.554,28,45,0.622,13,29,0.448,24,29,0.828
1/30/2017,0,PHO,MEM,L ,96,115,240,31,74,0.419,26,55,0.473,5,19,0.263,29,39,0.744,39,80,0.488,23,52,0.442,16,28,0.571,21,24,0.875
1/29/2017,23,ATL,NYK,W ,142,139,340,52,119,0.437,42,88,0.477,10,31,0.323,28,40,0.7,51,128,0.398,33,77,0.429,18,51,0.353,19,23,0.826
1/29/2017,3,CHI,PHI,W ,121,108,240,45,89,0.506,37,75,0.493,8,14,0.571,23,28,0.821,44,99,0.444,34,71,0.479,10,28,0.357,10,14,0.714
1/29/2017,4,CLE,OKC,W ,107,91,240,41,92,0.446,33,63,0.524,8,29,0.276,17,22,0.773,37,100,0.37,31,74,0.419,6,26,0.231,11,16,0.688
1/29/2017,3,IND,HOU,W ,120,101,240,47,87,0.54,42,66,0.636,5,21,0.238,21,26,0.808,34,83,0.41,23,44,0.523,11,39,0.282,22,25,0.88
1/29/2017,2,NOP,WAS,L ,94,107,240,38,84,0.452,28,52,0.538,10,32,0.313,8,15,0.533,45,89,0.506,35,68,0.515,10,21,0.476,7,10,0.7
1/29/2017,1,POR,GSW,L ,111,113,240,46,93,0.495,36,66,0.545,10,27,0.37,9,12,0.75,36,79,0.456,28,53,0.528,8,26,0.308,33,39,0.846
1/29/2017,11,SAS,DAL,L ,101,105,240,39,83,0.47,31,61,0.508,8,22,0.364,15,23,0.652,39,87,0.448,27,53,0.509,12,34,0.353,15,16,0.938
1/29/2017,10,TOR,ORL,L ,113,114,240,36,79,0.456,24,51,0.471,12,28,0.429,29,36,0.806,42,79,0.532,32,56,0.571,10,23,0.435,20,26,0.769
1/28/2017,12,CHO,SAC,L ,106,109,240,36,75,0.48,24,38,0.632,12,37,0.324,22,24,0.917,41,79,0.519,30,52,0.577,11,27,0.407,16,26,0.615
1/28/2017,1,GSW,LAC,W ,144,98,240,57,92,0.62,40,58,0.69,17,34,0.5,13,16,0.813,36,82,0.439,24,54,0.444,12,28,0.429,14,22,0.636
1/28/2017,21,MIA,DET,W ,116,103,240,42,80,0.525,28,52,0.538,14,28,0.5,18,23,0.783,46,89,0.517,42,77,0.545,4,12,0.333,7,12,0.583
1/28/2017,2,MIL,BOS,L ,108,112,265,37,87,0.425,28,66,0.424,9,21,0.429,25,32,0.781,37,89,0.416,23,48,0.479,14,41,0.341,24,30,0.8
1/28/2017,0,MIN,BRK,W ,129,109,240,47,93,0.505,38,73,0.521,9,20,0.45,26,32,0.813,41,85,0.482,34,64,0.531,7,21,0.333,20,25,0.8
1/28/2017,3,PHO,DEN,L ,112,123,240,41,91,0.451,35,70,0.5,6,21,0.286,24,32,0.75,39,80,0.488,31,55,0.564,8,25,0.32,37,42,0.881
1/28/2017,7,UTA,MEM,L ,95,102,240,29,62,0.468,19,37,0.514,10,25,0.4,27,29,0.931,41,80,0.513,30,54,0.556,11,26,0.423,9,10,0.9
1/27/2017,0,ATL,WAS,L ,86,112,240,30,83,0.361,21,52,0.404,9,31,0.29,17,25,0.68,43,89,0.483,30,58,0.517,13,31,0.419,13,19,0.684
1/27/2017,3,BOS,ORL,W ,128,98,240,50,89,0.562,34,55,0.618,16,34,0.471,12,15,0.8,38,87,0.437,29,62,0.468,9,25,0.36,13,18,0.722
1/27/2017,9,CHI,MIA,L ,88,100,240,33,78,0.423,30,65,0.462,3,13,0.231,19,25,0.76,41,89,0.461,32,65,0.492,9,24,0.375,9,11,0.818
1/27/2017,4,CLE,BRK,W ,124,116,240,49,92,0.533,36,56,0.643,13,36,0.361,13,20,0.65,43,87,0.494,27,54,0.5,16,33,0.485,14,16,0.875
1/27/2017,11,IND,SAC,W ,115,111,265,38,78,0.487,28,50,0.56,10,28,0.357,29,33,0.879,35,70,0.5,22,45,0.489,13,25,0.52,28,36,0.778
1/27/2017,8,NOP,SAS,W ,119,103,240,48,93,0.516,35,63,0.556,13,30,0.433,10,14,0.714,33,85,0.388,21,57,0.368,12,28,0.429,25,29,0.862
1/27/2017,6,NYK,CHO,W ,110,107,240,46,96,0.479,37,69,0.536,9,27,0.333,9,13,0.692,40,90,0.444,27,53,0.509,13,37,0.351,14,15,0.933
1/27/2017,5,PHI,HOU,L ,118,123,240,42,78,0.538,32,53,0.604,10,25,0.4,24,32,0.75,42,81,0.519,30,50,0.6,12,31,0.387,27,28,0.964
1/27/2017,6,POR,MEM,W ,112,109,240,38,81,0.469,22,46,0.478,16,35,0.457,20,21,0.952,37,77,0.481,28,51,0.549,9,26,0.346,26,33,0.788
1/27/2017,2,TOR,MIL,W ,102,86,240,37,84,0.44,27,59,0.458,10,25,0.4,18,23,0.783,31,80,0.388,24,57,0.421,7,23,0.304,17,24,0.708
1/26/2017,8,DEN,PHO,W ,127,120,240,44,86,0.512,35,63,0.556,9,23,0.391,30,35,0.857,48,89,0.539,38,65,0.585,10,24,0.417,14,17,0.824
1/26/2017,4,MIN,IND,L ,103,109,240,36,81,0.444,26,54,0.481,10,27,0.37,21,27,0.778,42,81,0.519,32,63,0.508,10,18,0.556,15,17,0.882
1/26/2017,13,OKC,DAL,W ,109,98,240,37,72,0.514,28,50,0.56,9,22,0.409,26,36,0.722,38,84,0.452,27,58,0.466,11,26,0.423,11,13,0.846
1/26/2017,5,UTA,LAL,W ,96,88,240,33,81,0.407,27,55,0.491,6,26,0.231,24,28,0.857,36,84,0.429,32,70,0.457,4,14,0.286,12,13,0.923
1/25/2017,11,BOS,HOU,W ,120,109,240,47,91,0.516,36,59,0.61,11,32,0.344,15,16,0.938,36,77,0.468,26,46,0.565,10,31,0.323,27,38,0.711
1/25/2017,8,BRK,MIA,L ,106,109,240,35,80,0.438,22,45,0.489,13,35,0.371,23,26,0.885,40,83,0.482,29,60,0.483,11,23,0.478,18,25,0.72
1/25/2017,1,CHI,ATL,L ,114,119,240,43,94,0.457,35,67,0.522,8,27,0.296,20,26,0.769,43,83,0.518,26,53,0.491,17,30,0.567,16,19,0.842
1/25/2017,5,CHO,GSW,L ,103,113,240,38,92,0.413,31,69,0.449,7,23,0.304,20,21,0.952,39,82,0.476,28,54,0.519,11,28,0.393,24,27,0.889
1/25/2017,16,CLE,SAC,L ,112,116,265,40,82,0.488,25,44,0.568,15,38,0.395,17,34,0.5,43,95,0.453,32,64,0.5,11,31,0.355,19,22,0.864
1/25/2017,5,DAL,NYK,W ,103,95,240,39,83,0.47,33,57,0.579,6,26,0.231,19,24,0.792,39,92,0.424,32,69,0.464,7,23,0.304,10,12,0.833
1/25/2017,10,MEM,TOR,W ,101,99,240,36,78,0.462,26,56,0.464,10,22,0.455,19,25,0.76,39,92,0.424,29,58,0.5,10,34,0.294,11,19,0.579
1/25/2017,21,MIL,PHI,L ,109,114,240,42,91,0.462,35,63,0.556,7,28,0.25,18,23,0.783,40,75,0.533,28,49,0.571,12,26,0.462,22,25,0.88
1/25/2017,1,NOP,OKC,L ,105,114,240,41,96,0.427,30,69,0.435,11,27,0.407,12,19,0.632,42,91,0.462,32,64,0.5,10,27,0.37,20,28,0.714
1/25/2017,9,POR,LAL,W ,105,98,240,43,90,0.478,39,75,0.52,4,15,0.267,15,20,0.75,37,94,0.394,26,64,0.406,11,30,0.367,13,14,0.929
1/24/2017,4,DEN,UTA,W ,103,93,240,35,76,0.461,25,50,0.5,10,26,0.385,23,31,0.742,35,85,0.412,28,63,0.444,7,22,0.318,16,21,0.762
1/24/2017,12,ORL,CHI,L ,92,100,240,35,85,0.412,28,63,0.444,7,22,0.318,15,20,0.75,35,77,0.455,28,55,0.509,7,22,0.318,23,30,0.767
1/24/2017,7,PHI,LAC,W ,121,110,240,45,90,0.5,35,61,0.574,10,29,0.345,21,22,0.955,33,71,0.465,15,37,0.405,18,34,0.529,26,41,0.634
1/24/2017,8,PHO,MIN,L ,111,112,240,38,86,0.442,31,67,0.463,7,19,0.368,28,32,0.875,44,84,0.524,38,67,0.567,6,17,0.353,18,24,0.75
1/24/2017,10,TOR,SAS,L ,106,108,240,38,84,0.452,32,59,0.542,6,25,0.24,24,28,0.857,38,85,0.447,31,61,0.508,7,24,0.292,25,33,0.758
1/24/2017,0,WAS,BOS,W ,123,108,240,48,84,0.571,39,64,0.609,9,20,0.45,18,21,0.857,38,84,0.452,28,51,0.549,10,33,0.303,22,24,0.917
1/23/2017,3,ATL,LAC,L ,105,115,240,37,88,0.42,28,59,0.475,9,29,0.31,22,26,0.846,42,84,0.5,28,60,0.467,14,24,0.583,17,22,0.773
1/23/2017,5,BRK,SAS,L ,86,112,240,32,81,0.395,27,56,0.482,5,25,0.2,17,18,0.944,45,95,0.474,36,73,0.493,9,22,0.409,13,16,0.813
1/23/2017,1,CHO,WAS,L ,99,109,240,35,90,0.389,27,58,0.466,8,32,0.25,21,25,0.84,43,80,0.538,33,55,0.6,10,25,0.4,13,17,0.765
1/23/2017,6,DET,SAC,L ,104,109,240,41,82,0.5,31,54,0.574,10,28,0.357,12,17,0.706,40,82,0.488,31,61,0.508,9,21,0.429,20,26,0.769
1/23/2017,6,IND,NYK,L ,103,109,240,38,86,0.442,31,60,0.517,7,26,0.269,20,25,0.8,35,76,0.461,27,54,0.5,8,22,0.364,31,35,0.886
1/23/2017,12,MIA,GSW,W ,105,102,240,38,86,0.442,25,56,0.446,13,30,0.433,16,27,0.593,41,88,0.466,33,58,0.569,8,30,0.267,12,20,0.6
1/23/2017,5,MIL,HOU,W ,127,114,240,47,80,0.588,36,57,0.632,11,23,0.478,22,27,0.815,39,77,0.506,25,42,0.595,14,35,0.4,22,28,0.786
1/23/2017,0,NOP,CLE,W ,124,122,240,43,87,0.494,27,48,0.563,16,39,0.41,22,30,0.733,43,93,0.462,28,56,0.5,15,37,0.405,21,25,0.84
1/23/2017,16,UTA,OKC,L ,95,97,240,36,84,0.429,31,63,0.492,5,21,0.238,18,26,0.692,36,83,0.434,30,63,0.476,6,20,0.3,19,25,0.76
1/22/2017,3,DAL,LAL,W ,122,73,240,43,87,0.494,26,48,0.542,17,39,0.436,19,19,1,28,73,0.384,25,52,0.481,3,21,0.143,14,17,0.824
1/22/2017,11,MIN,DEN,W ,111,108,240,45,85,0.529,39,70,0.557,6,15,0.4,15,21,0.714,42,82,0.512,35,58,0.603,7,24,0.292,17,21,0.81
1/22/2017,6,ORL,GSW,L ,98,118,240,42,96,0.438,35,68,0.515,7,28,0.25,7,16,0.438,42,89,0.472,23,47,0.489,19,42,0.452,15,19,0.789
1/22/2017,8,TOR,PHO,L ,103,115,240,33,83,0.398,26,56,0.464,7,27,0.259,30,35,0.857,40,79,0.506,31,57,0.544,9,22,0.409,26,28,0.929
1/21/2017,7,ATL,PHI,W ,110,93,240,45,91,0.495,38,71,0.535,7,20,0.35,13,23,0.565,33,78,0.423,21,49,0.429,12,29,0.414,15,18,0.833
1/21/2017,27,BOS,POR,L ,123,127,265,42,92,0.457,29,57,0.509,13,35,0.371,26,31,0.839,43,92,0.467,33,67,0.493,10,25,0.4,31,36,0.861
1/21/2017,15,CHI,SAC,W ,102,99,240,34,83,0.41,28,66,0.424,6,17,0.353,28,33,0.848,37,84,0.44,28,58,0.483,9,26,0.346,16,21,0.762
1/21/2017,11,CHO,BRK,W ,112,105,240,39,82,0.476,25,52,0.481,14,30,0.467,20,22,0.909,38,88,0.432,21,47,0.447,17,41,0.415,12,15,0.8
1/21/2017,15,CLE,SAS,L ,115,118,265,45,91,0.495,32,57,0.561,13,34,0.382,12,22,0.545,48,96,0.5,38,70,0.543,10,26,0.385,12,14,0.857
1/21/2017,0,DEN,LAC,W ,123,98,240,46,87,0.529,36,63,0.571,10,24,0.417,21,26,0.808,40,96,0.417,30,64,0.469,10,32,0.313,8,8,1
1/21/2017,5,DET,WAS,W ,113,112,240,43,87,0.494,32,59,0.542,11,28,0.393,16,22,0.727,39,91,0.429,31,65,0.477,8,26,0.308,26,33,0.788
1/21/2017,2,MEM,HOU,L ,95,119,240,33,89,0.371,24,55,0.436,9,34,0.265,20,28,0.714,41,80,0.513,25,38,0.658,16,42,0.381,21,25,0.84
1/21/2017,3,MIA,MIL,W ,109,97,240,41,77,0.532,28,47,0.596,13,30,0.433,14,22,0.636,33,79,0.418,27,61,0.443,6,18,0.333,25,32,0.781
1/21/2017,15,NYK,PHO,L ,105,107,240,40,89,0.449,29,68,0.426,11,21,0.524,14,16,0.875,37,85,0.435,28,61,0.459,9,24,0.375,24,27,0.889
1/21/2017,0,UTA,IND,W ,109,100,240,39,84,0.464,33,60,0.55,6,24,0.25,25,32,0.781,39,77,0.506,29,57,0.509,10,20,0.5,12,17,0.706
1/20/2017,1,ATL,CHI,W ,102,93,240,39,82,0.476,30,60,0.5,9,22,0.409,15,19,0.789,34,81,0.42,27,53,0.509,7,28,0.25,18,19,0.947
1/20/2017,1,CHO,TOR,W ,113,78,240,40,80,0.5,28,55,0.509,12,25,0.48,21,25,0.84,29,86,0.337,22,56,0.393,7,30,0.233,13,14,0.929
1/20/2017,18,DAL,UTA,L ,107,112,265,39,87,0.448,31,64,0.484,8,23,0.348,21,28,0.75,38,83,0.458,30,60,0.5,8,23,0.348,28,39,0.718
1/20/2017,3,HOU,GSW,L ,108,125,240,43,96,0.448,36,61,0.59,7,35,0.2,15,18,0.833,47,89,0.528,32,51,0.627,15,38,0.395,16,21,0.762
1/20/2017,14,LAL,IND,W ,108,95,240,41,87,0.471,27,54,0.5,14,33,0.424,12,15,0.8,34,80,0.425,25,57,0.439,9,23,0.391,18,25,0.72
1/20/2017,5,MEM,SAC,W ,107,91,240,38,83,0.458,27,55,0.491,11,28,0.393,20,25,0.8,31,76,0.408,25,47,0.532,6,29,0.207,23,32,0.719
1/20/2017,8,NOP,BRK,L ,114,143,240,43,105,0.41,32,71,0.451,11,34,0.324,17,23,0.739,48,83,0.578,33,53,0.623,15,30,0.5,32,35,0.914
1/20/2017,1,ORL,MIL,W ,112,96,240,40,87,0.46,32,59,0.542,8,28,0.286,24,31,0.774,34,83,0.41,24,58,0.414,10,25,0.4,18,26,0.692
1/20/2017,7,PHI,POR,W ,93,92,240,36,92,0.391,24,63,0.381,12,29,0.414,9,16,0.563,33,89,0.371,27,70,0.386,6,19,0.316,20,28,0.714
1/19/2017,4,CLE,PHO,W ,118,103,240,43,85,0.506,24,43,0.558,19,42,0.452,13,19,0.684,37,85,0.435,33,66,0.5,4,19,0.211,25,31,0.806
1/19/2017,4,LAC,MIN,L ,101,104,240,42,87,0.483,38,65,0.585,4,22,0.182,13,24,0.542,40,84,0.476,35,68,0.515,5,16,0.313,19,25,0.76
1/19/2017,4,MIA,DAL,W ,99,95,240,35,73,0.479,26,53,0.491,9,20,0.45,20,29,0.69,37,82,0.451,23,46,0.5,14,36,0.389,7,11,0.636
1/19/2017,5,NYK,WAS,L ,110,113,240,42,90,0.467,35,66,0.53,7,24,0.292,19,22,0.864,44,88,0.5,31,56,0.554,13,32,0.406,12,14,0.857
1/19/2017,7,SAS,DEN,W ,118,104,240,44,86,0.512,35,64,0.547,9,22,0.409,21,25,0.84,37,91,0.407,27,60,0.45,10,31,0.323,20,26,0.769
1/18/2017,4,BOS,NYK,L ,106,117,240,35,91,0.385,26,58,0.448,9,33,0.273,27,29,0.931,46,91,0.505,36,66,0.545,10,25,0.4,15,18,0.833
1/18/2017,7,CHO,POR,W ,107,85,240,41,87,0.471,30,61,0.492,11,26,0.423,14,17,0.824,33,94,0.351,25,63,0.397,8,31,0.258,11,11,1
1/18/2017,0,DET,ATL,W ,118,95,240,45,91,0.495,35,66,0.53,10,25,0.4,18,28,0.643,30,78,0.385,24,53,0.453,6,25,0.24,29,37,0.784
1/18/2017,9,GSW,OKC,W ,121,100,240,46,85,0.541,36,64,0.563,10,21,0.476,19,27,0.704,38,90,0.422,30,62,0.484,8,28,0.286,16,19,0.842
1/18/2017,1,HOU,MIL,W ,111,92,240,43,95,0.453,29,51,0.569,14,44,0.318,11,15,0.733,37,93,0.398,30,65,0.462,7,28,0.25,11,14,0.786
1/18/2017,9,NOP,ORL,W ,118,98,240,46,93,0.495,31,57,0.544,15,36,0.417,11,15,0.733,39,88,0.443,28,56,0.5,11,32,0.344,9,11,0.818
1/18/2017,6,PHI,TOR,W ,94,89,240,31,69,0.449,23,45,0.511,8,24,0.333,24,32,0.75,34,86,0.395,28,62,0.452,6,24,0.25,15,23,0.652
1/18/2017,2,SAC,IND,L ,100,106,240,35,72,0.486,26,51,0.51,9,21,0.429,21,27,0.778,39,75,0.52,32,54,0.593,7,21,0.333,21,25,0.84
1/18/2017,0,WAS,MEM,W ,104,101,240,36,80,0.45,28,51,0.549,8,29,0.276,24,26,0.923,33,83,0.398,25,58,0.431,8,25,0.32,27,34,0.794
1/17/2017,8,BRK,TOR,L ,109,119,240,40,89,0.449,33,63,0.524,7,26,0.269,22,24,0.917,48,92,0.522,38,73,0.521,10,19,0.526,13,16,0.813
1/17/2017,9,CHI,DAL,L ,98,99,240,37,82,0.451,31,68,0.456,6,14,0.429,18,22,0.818,37,78,0.474,26,50,0.52,11,28,0.393,14,18,0.778
1/17/2017,5,LAL,DEN,L ,121,127,240,47,108,0.435,36,78,0.462,11,30,0.367,16,18,0.889,50,88,0.568,39,62,0.629,11,26,0.423,16,26,0.615
1/17/2017,19,MIA,HOU,W ,109,103,240,42,90,0.467,33,61,0.541,9,29,0.31,16,24,0.667,36,90,0.4,27,51,0.529,9,39,0.231,22,28,0.786
1/17/2017,15,SAS,MIN,W ,122,114,240,43,84,0.512,35,66,0.53,8,18,0.444,28,35,0.8,36,73,0.493,30,60,0.5,6,13,0.462,36,41,0.878
1/16/2017,15,BOS,CHO,W ,108,98,240,42,84,0.5,27,45,0.6,15,39,0.385,9,10,0.9,38,86,0.442,30,61,0.492,8,25,0.32,14,17,0.824
1/16/2017,2,DEN,ORL,W ,125,112,240,52,89,0.584,43,62,0.694,9,27,0.333,12,15,0.8,45,88,0.511,37,63,0.587,8,25,0.32,14,18,0.778
1/16/2017,0,GSW,CLE,W ,126,91,240,46,91,0.505,31,57,0.544,15,34,0.441,19,24,0.792,31,88,0.352,22,54,0.407,9,34,0.265,20,27,0.741
1/16/2017,1,IND,NOP,W ,98,95,240,41,81,0.506,36,62,0.581,5,19,0.263,11,16,0.688,36,83,0.434,26,58,0.448,10,25,0.4,13,18,0.722
1/16/2017,1,LAC,OKC,W ,120,98,240,45,82,0.549,33,54,0.611,12,28,0.429,18,22,0.818,36,85,0.424,26,55,0.473,10,30,0.333,16,19,0.842
1/16/2017,11,MIL,PHI,L ,104,113,240,42,89,0.472,37,75,0.493,5,14,0.357,15,22,0.682,35,78,0.449,21,41,0.512,14,37,0.378,29,36,0.806
1/16/2017,21,NYK,ATL,L ,107,108,240,42,85,0.494,34,59,0.576,8,26,0.308,15,23,0.652,40,87,0.46,28,55,0.509,12,32,0.375,16,23,0.696
1/16/2017,10,PHO,UTA,L ,101,106,240,40,81,0.494,35,59,0.593,5,22,0.227,16,17,0.941,41,89,0.461,33,66,0.5,8,23,0.348,16,24,0.667
1/16/2017,0,WAS,POR,W ,120,101,240,42,86,0.488,29,63,0.46,13,23,0.565,23,25,0.92,37,88,0.42,29,62,0.468,8,26,0.308,19,25,0.76
1/15/2017,5,ATL,MIL,W ,111,98,240,42,80,0.525,29,54,0.537,13,26,0.5,14,18,0.778,39,79,0.494,33,60,0.55,6,19,0.316,14,18,0.778
1/15/2017,6,BRK,HOU,L ,112,137,240,41,93,0.441,26,49,0.531,15,44,0.341,15,19,0.789,46,92,0.5,25,48,0.521,21,44,0.477,24,32,0.75
1/15/2017,1,DAL,MIN,W ,98,87,240,36,77,0.468,24,48,0.5,12,29,0.414,14,19,0.737,35,80,0.438,30,59,0.508,5,21,0.238,12,18,0.667
1/15/2017,13,LAL,DET,L ,97,102,240,36,83,0.434,30,57,0.526,6,26,0.231,19,24,0.792,41,95,0.432,32,70,0.457,9,25,0.36,11,16,0.688
1/15/2017,16,MEM,CHI,L ,104,108,240,40,95,0.421,29,63,0.46,11,32,0.344,13,13,1,40,78,0.513,36,61,0.59,4,17,0.235,24,35,0.686
1/15/2017,6,SAC,OKC,L ,118,122,240,37,81,0.457,28,56,0.5,9,25,0.36,35,40,0.875,40,90,0.444,31,62,0.5,9,28,0.321,33,41,0.805
1/15/2017,3,TOR,NYK,W ,116,101,240,44,89,0.494,36,67,0.537,8,22,0.364,20,23,0.87,35,84,0.417,23,55,0.418,12,29,0.414,19,27,0.704
1/14/2017,3,CHI,NOP,W ,107,99,240,43,101,0.426,35,81,0.432,8,20,0.4,13,23,0.565,39,84,0.464,32,61,0.525,7,23,0.304,14,21,0.667
1/14/2017,0,LAC,LAL,W ,113,97,240,48,92,0.522,38,64,0.594,10,28,0.357,7,8,0.875,36,80,0.45,26,59,0.441,10,21,0.476,15,27,0.556
1/14/2017,9,PHO,SAS,W ,108,105,240,39,85,0.459,31,64,0.484,8,21,0.381,22,24,0.917,36,71,0.507,27,51,0.529,9,20,0.45,24,34,0.706
1/14/2017,5,UTA,ORL,W ,114,107,240,41,83,0.494,34,57,0.596,7,26,0.269,25,36,0.694,38,82,0.463,26,48,0.542,12,34,0.353,19,27,0.704
1/14/2017,2,WAS,PHI,W ,109,93,240,44,91,0.484,36,74,0.486,8,17,0.471,13,18,0.722,36,87,0.414,26,56,0.464,10,31,0.323,11,21,0.524
1/13/2017,3,ATL,BOS,L ,101,103,240,36,84,0.429,25,54,0.463,11,30,0.367,18,21,0.857,36,83,0.434,19,39,0.487,17,44,0.386,14,19,0.737
1/13/2017,4,HOU,MEM,L ,105,110,240,33,82,0.402,23,41,0.561,10,41,0.244,29,36,0.806,41,76,0.539,31,49,0.633,10,27,0.37,18,27,0.667
1/13/2017,0,MIL,MIA,W ,116,108,240,40,80,0.5,31,65,0.477,9,15,0.6,27,31,0.871,41,83,0.494,29,51,0.569,12,32,0.375,14,18,0.778
1/13/2017,4,MIN,OKC,W ,96,86,240,39,86,0.453,34,68,0.5,5,18,0.278,13,14,0.929,33,85,0.388,30,65,0.462,3,20,0.15,17,21,0.81
1/13/2017,0,PHI,CHO,W ,102,93,240,36,76,0.474,22,38,0.579,14,38,0.368,16,20,0.8,28,85,0.329,22,62,0.355,6,23,0.261,31,32,0.969
1/13/2017,6,POR,ORL,L ,109,115,240,39,97,0.402,29,63,0.46,10,34,0.294,21,25,0.84,41,83,0.494,31,65,0.477,10,18,0.556,23,26,0.885
1/13/2017,1,SAC,CLE,L ,108,120,240,42,80,0.525,33,55,0.6,9,25,0.36,15,19,0.789,44,87,0.506,29,50,0.58,15,37,0.405,17,22,0.773
1/13/2017,16,TOR,BRK,W ,132,113,240,52,97,0.536,41,69,0.594,11,28,0.393,17,21,0.81,40,86,0.465,23,50,0.46,17,36,0.472,16,20,0.8
1/13/2017,6,UTA,DET,W ,110,77,240,43,80,0.538,27,49,0.551,16,31,0.516,8,13,0.615,30,76,0.395,24,59,0.407,6,17,0.353,11,16,0.688
1/12/2017,16,BRK,NOP,L ,95,104,240,40,97,0.412,31,55,0.564,9,42,0.214,6,11,0.545,38,90,0.422,27,58,0.466,11,32,0.344,17,25,0.68
1/12/2017,2,DEN,IND,W ,140,112,240,52,90,0.578,37,58,0.638,15,32,0.469,21,23,0.913,44,94,0.468,32,65,0.492,12,29,0.414,12,13,0.923
1/12/2017,21,GSW,DET,W ,127,107,240,50,89,0.562,35,60,0.583,15,29,0.517,12,18,0.667,43,88,0.489,37,60,0.617,6,28,0.214,15,20,0.75
1/12/2017,6,NYK,CHI,W ,104,89,240,44,92,0.478,37,69,0.536,7,23,0.304,9,11,0.818,35,89,0.393,32,71,0.451,3,18,0.167,16,21,0.762
1/12/2017,16,PHO,DAL,L ,108,113,240,38,78,0.487,28,60,0.467,10,18,0.556,22,27,0.815,43,89,0.483,28,55,0.509,15,34,0.441,12,17,0.706
1/12/2017,0,SAS,LAL,W ,134,94,240,49,81,0.605,39,60,0.65,10,21,0.476,26,29,0.897,35,85,0.412,29,65,0.446,6,20,0.3,18,25,0.72
1/11/2017,12,BOS,WAS,W ,117,108,240,43,85,0.506,26,44,0.591,17,41,0.415,14,18,0.778,45,105,0.429,35,79,0.443,10,26,0.385,8,12,0.667
1/11/2017,12,LAC,ORL,W ,105,96,240,39,76,0.513,30,50,0.6,9,26,0.346,18,26,0.692,39,92,0.424,33,65,0.508,6,27,0.222,12,18,0.667
1/11/2017,8,MIN,HOU,W ,119,105,240,44,81,0.543,36,58,0.621,8,23,0.348,23,25,0.92,36,87,0.414,21,45,0.467,15,42,0.357,18,22,0.818
1/11/2017,0,OKC,MEM,W ,103,95,240,36,81,0.444,28,55,0.509,8,26,0.308,23,29,0.793,38,92,0.413,31,68,0.456,7,24,0.292,12,21,0.571
1/11/2017,14,PHI,NYK,W ,98,97,240,37,95,0.389,30,67,0.448,7,28,0.25,17,21,0.81,42,86,0.488,38,64,0.594,4,22,0.182,9,10,0.9
1/11/2017,4,POR,CLE,W ,102,86,240,40,93,0.43,30,63,0.476,10,30,0.333,12,16,0.75,28,82,0.341,19,52,0.365,9,30,0.3,21,28,0.75
1/10/2017,0,BRK,ATL,L ,97,117,240,35,87,0.402,25,58,0.431,10,29,0.345,17,23,0.739,44,92,0.478,37,69,0.536,7,23,0.304,22,38,0.579
1/10/2017,4,GSW,MIA,W ,107,95,240,39,86,0.453,28,59,0.475,11,27,0.407,18,22,0.818,38,90,0.422,32,60,0.533,6,30,0.2,13,17,0.765
1/10/2017,4,HOU,CHO,W ,121,114,240,40,82,0.488,23,43,0.535,17,39,0.436,24,33,0.727,44,92,0.478,25,49,0.51,19,43,0.442,7,9,0.778
1/10/2017,12,LAL,POR,L ,87,108,240,32,83,0.386,23,59,0.39,9,24,0.375,14,26,0.538,43,85,0.506,36,64,0.563,7,21,0.333,15,20,0.75
1/10/2017,6,SAC,DET,W ,100,94,240,32,73,0.438,19,50,0.38,13,23,0.565,23,29,0.793,36,82,0.439,24,55,0.436,12,27,0.444,10,16,0.625
1/10/2017,7,SAS,MIL,L ,107,109,240,42,88,0.477,30,58,0.517,12,30,0.4,11,14,0.786,44,84,0.524,34,65,0.523,10,19,0.526,11,13,0.846
1/10/2017,10,TOR,BOS,W ,114,106,240,41,87,0.471,31,65,0.477,10,22,0.455,22,27,0.815,40,85,0.471,31,58,0.534,9,27,0.333,17,20,0.85
1/10/2017,7,UTA,CLE,W ,100,92,240,38,79,0.481,25,45,0.556,13,34,0.382,11,19,0.579,31,85,0.365,22,54,0.407,9,31,0.29,21,25,0.84
1/10/2017,8,WAS,CHI,W ,101,99,240,42,83,0.506,31,61,0.508,11,22,0.5,6,9,0.667,35,88,0.398,25,61,0.41,10,27,0.37,19,21,0.905
1/9/2017,1,CHI,OKC,L ,94,109,240,34,83,0.41,27,64,0.422,7,19,0.368,19,22,0.864,47,83,0.566,40,59,0.678,7,24,0.292,8,11,0.727
1/9/2017,1,MIN,DAL,W ,101,92,240,40,71,0.563,34,55,0.618,6,16,0.375,15,21,0.714,36,78,0.462,23,50,0.46,13,28,0.464,7,9,0.778
1/9/2017,11,NYK,NOP,L ,96,110,240,36,85,0.424,25,56,0.446,11,29,0.379,13,16,0.813,41,84,0.488,29,57,0.509,12,27,0.444,16,19,0.842
1/8/2017,5,BRK,PHI,L ,95,105,240,36,78,0.462,26,51,0.51,10,27,0.37,13,17,0.765,37,94,0.394,29,67,0.433,8,27,0.296,23,27,0.852
1/8/2017,3,LAC,MIA,W ,98,86,240,36,86,0.419,27,56,0.482,9,30,0.3,17,25,0.68,31,84,0.369,24,57,0.421,7,27,0.259,17,21,0.81
1/8/2017,1,LAL,ORL,W ,111,95,240,42,87,0.483,34,55,0.618,8,32,0.25,19,24,0.792,34,90,0.378,27,64,0.422,7,26,0.269,20,29,0.69
1/8/2017,4,MEM,UTA,W ,88,79,240,34,78,0.436,25,54,0.463,9,24,0.375,11,14,0.786,28,72,0.389,19,49,0.388,9,23,0.391,14,23,0.609
1/8/2017,12,MIL,WAS,L ,101,107,240,37,80,0.463,28,57,0.491,9,23,0.391,18,20,0.9,41,84,0.488,31,52,0.596,10,32,0.313,15,18,0.833
1/8/2017,9,PHO,CLE,L ,116,120,240,46,87,0.529,37,60,0.617,9,27,0.333,15,19,0.789,44,82,0.537,29,48,0.604,15,34,0.441,17,19,0.895
1/8/2017,14,POR,DET,L ,124,125,290,51,98,0.52,36,63,0.571,15,35,0.429,7,12,0.583,54,105,0.514,46,80,0.575,8,25,0.32,9,12,0.75
1/8/2017,1,SAC,GSW,L ,106,117,240,36,74,0.486,25,46,0.543,11,28,0.393,23,29,0.793,45,89,0.506,35,60,0.583,10,29,0.345,17,20,0.85
1/8/2017,9,TOR,HOU,L ,122,129,240,42,78,0.538,31,53,0.585,11,25,0.44,27,30,0.9,46,89,0.517,35,51,0.686,11,38,0.289,26,31,0.839
1/7/2017,1,BOS,NOP,W ,117,108,240,40,93,0.43,22,57,0.386,18,36,0.5,19,21,0.905,40,85,0.471,30,54,0.556,10,31,0.323,18,23,0.783
1/7/2017,16,CHI,TOR,W ,123,118,265,38,97,0.392,27,69,0.391,11,28,0.393,36,39,0.923,37,85,0.435,29,54,0.537,8,31,0.258,36,43,0.837
1/7/2017,5,DAL,ATL,L ,82,97,240,32,82,0.39,23,46,0.5,9,36,0.25,9,10,0.9,30,74,0.405,19,52,0.365,11,22,0.5,26,32,0.813
1/7/2017,4,IND,NYK,W ,123,109,240,43,86,0.5,32,62,0.516,11,24,0.458,26,28,0.929,40,87,0.46,28,56,0.5,12,31,0.387,17,24,0.708
1/7/2017,12,MIN,UTA,L ,92,94,240,35,80,0.438,28,60,0.467,7,20,0.35,15,21,0.714,32,77,0.416,24,54,0.444,8,23,0.348,22,28,0.786
1/7/2017,7,OKC,DEN,W ,121,106,240,43,89,0.483,31,53,0.585,12,36,0.333,23,29,0.793,40,99,0.404,31,75,0.413,9,24,0.375,17,24,0.708
1/7/2017,20,SAS,CHO,W ,102,85,240,36,89,0.404,23,55,0.418,13,34,0.382,17,20,0.85,30,75,0.4,26,54,0.481,4,21,0.19,21,25,0.84
1/6/2017,7,BOS,PHI,W ,110,106,240,35,87,0.402,16,47,0.34,19,40,0.475,21,25,0.84,37,79,0.468,28,51,0.549,9,28,0.321,23,26,0.885
1/6/2017,9,BRK,CLE,L ,108,116,240,41,91,0.451,32,61,0.525,9,30,0.3,17,19,0.895,38,88,0.432,29,55,0.527,9,33,0.273,31,43,0.721
1/6/2017,1,GSW,MEM,L ,119,128,265,41,83,0.494,33,53,0.623,8,30,0.267,29,39,0.744,50,103,0.485,37,70,0.529,13,33,0.394,15,19,0.789
1/6/2017,6,LAL,MIA,W ,127,100,240,48,96,0.5,38,68,0.559,10,28,0.357,21,29,0.724,38,92,0.413,30,60,0.5,8,32,0.25,16,27,0.593
1/6/2017,6,MIL,NYK,L ,111,116,240,39,78,0.5,27,56,0.482,12,22,0.545,21,28,0.75,41,83,0.494,28,60,0.467,13,23,0.565,21,27,0.778
1/6/2017,14,ORL,HOU,L ,93,100,240,38,91,0.418,30,68,0.441,8,23,0.348,9,13,0.692,39,86,0.453,24,37,0.649,15,49,0.306,7,12,0.583
1/6/2017,1,SAC,LAC,L ,98,106,240,36,87,0.414,27,57,0.474,9,30,0.3,17,22,0.773,39,84,0.464,26,53,0.491,13,31,0.419,15,21,0.714
1/6/2017,10,WAS,MIN,W ,112,105,240,46,79,0.582,34,57,0.596,12,22,0.545,8,9,0.889,42,88,0.477,35,70,0.5,7,18,0.389,14,17,0.824
1/5/2017,14,DAL,PHO,L ,95,102,240,36,79,0.456,27,50,0.54,9,29,0.31,14,17,0.824,38,85,0.447,31,68,0.456,7,17,0.412,19,22,0.864
1/5/2017,8,DEN,SAS,L ,99,127,240,39,86,0.453,32,61,0.525,7,25,0.28,14,17,0.824,51,90,0.567,39,66,0.591,12,24,0.5,13,17,0.765
1/5/2017,0,DET,CHO,W ,115,114,240,39,97,0.402,29,69,0.42,10,28,0.357,27,32,0.844,37,91,0.407,27,65,0.415,10,26,0.385,30,34,0.882
1/5/2017,3,HOU,OKC,W ,118,116,240,41,86,0.477,26,47,0.553,15,39,0.385,21,30,0.7,41,91,0.451,29,61,0.475,12,30,0.4,22,27,0.815
1/5/2017,4,IND,BRK,W ,121,109,240,48,93,0.516,38,71,0.535,10,22,0.455,15,19,0.789,41,90,0.456,24,52,0.462,17,38,0.447,10,13,0.769
1/5/2017,11,NOP,ATL,L ,94,99,240,34,93,0.366,19,58,0.328,15,35,0.429,11,14,0.786,38,90,0.422,29,67,0.433,9,23,0.391,14,17,0.824
1/5/2017,14,POR,LAL,W ,118,109,240,43,81,0.531,31,48,0.646,12,33,0.364,20,30,0.667,36,86,0.419,26,55,0.473,10,31,0.323,27,33,0.818
1/5/2017,1,TOR,UTA,W ,101,93,240,36,91,0.396,28,70,0.4,8,21,0.381,21,28,0.75,34,73,0.466,27,53,0.509,7,20,0.35,18,21,0.857
1/4/2017,7,CHO,OKC,W ,123,112,240,37,80,0.463,28,56,0.5,9,24,0.375,40,49,0.816,42,96,0.438,33,66,0.5,9,30,0.3,19,23,0.826
1/4/2017,3,CLE,CHI,L ,94,106,240,34,83,0.41,26,58,0.448,8,25,0.32,18,24,0.75,41,85,0.482,28,55,0.509,13,30,0.433,11,15,0.733
1/4/2017,6,GSW,POR,W ,125,117,240,44,87,0.506,31,51,0.608,13,36,0.361,24,29,0.828,40,89,0.449,28,63,0.444,12,26,0.462,25,28,0.893
1/4/2017,10,LAC,MEM,W ,115,106,240,37,73,0.507,28,50,0.56,9,23,0.391,32,45,0.711,38,88,0.432,27,60,0.45,11,28,0.393,19,25,0.76
1/4/2017,13,NYK,MIL,L ,104,105,240,42,94,0.447,29,66,0.439,13,28,0.464,7,12,0.583,37,78,0.474,28,50,0.56,9,28,0.321,22,31,0.71
1/4/2017,2,ORL,ATL,L ,92,111,240,37,86,0.43,28,58,0.483,9,28,0.321,9,10,0.9,44,81,0.543,34,62,0.548,10,19,0.526,13,18,0.722
1/4/2017,3,SAC,MIA,L ,102,107,240,40,78,0.513,32,58,0.552,8,20,0.4,14,17,0.824,35,72,0.486,23,44,0.523,12,28,0.429,25,29,0.862
1/3/2017,4,BOS,UTA,W ,115,104,240,41,74,0.554,24,43,0.558,17,31,0.548,16,17,0.941,38,82,0.463,27,56,0.482,11,26,0.423,17,21,0.81
1/3/2017,14,DAL,WAS,W ,113,105,240,37,78,0.474,20,46,0.435,17,32,0.531,22,24,0.917,41,92,0.446,30,62,0.484,11,30,0.367,12,14,0.857
1/3/2017,10,DEN,SAC,L ,113,120,240,41,82,0.5,23,44,0.523,18,38,0.474,13,13,1,46,88,0.523,35,59,0.593,11,29,0.379,17,18,0.944
1/3/2017,5,DET,IND,L ,116,121,240,48,97,0.495,38,68,0.559,10,29,0.345,10,12,0.833,43,74,0.581,34,58,0.586,9,16,0.563,26,30,0.867
1/3/2017,12,LAL,MEM,W ,116,102,240,42,82,0.512,25,49,0.51,17,33,0.515,15,28,0.536,30,77,0.39,20,46,0.435,10,31,0.323,32,35,0.914
1/3/2017,2,PHI,MIN,W ,93,91,240,33,85,0.388,26,53,0.491,7,32,0.219,20,25,0.8,33,82,0.402,26,58,0.448,7,24,0.292,18,20,0.9
1/3/2017,3,PHO,MIA,W ,99,90,240,36,77,0.468,27,54,0.5,9,23,0.391,18,22,0.818,36,91,0.396,30,68,0.441,6,23,0.261,12,16,0.75
1/3/2017,1,SAS,TOR,W ,110,82,240,43,78,0.551,30,54,0.556,13,24,0.542,11,15,0.733,31,83,0.373,27,65,0.415,4,18,0.222,16,22,0.727
1/2/2017,11,BRK,UTA,L ,89,101,240,33,78,0.423,27,51,0.529,6,27,0.222,17,23,0.739,39,93,0.419,32,69,0.464,7,24,0.292,16,20,0.8
1/2/2017,12,CHI,CHO,W ,118,111,240,42,90,0.467,35,67,0.522,7,23,0.304,27,29,0.931,41,83,0.494,32,64,0.5,9,19,0.474,20,22,0.909
1/2/2017,15,CLE,NOP,W ,90,82,240,34,90,0.378,28,59,0.475,6,31,0.194,16,22,0.727,32,88,0.364,21,62,0.339,11,26,0.423,7,10,0.7
1/2/2017,11,GSW,DEN,W ,127,119,240,50,95,0.526,39,70,0.557,11,25,0.44,16,21,0.762,48,101,0.475,39,66,0.591,9,35,0.257,14,18,0.778
1/2/2017,1,HOU,WAS,W ,101,91,240,37,86,0.43,25,47,0.532,12,39,0.308,15,21,0.714,38,87,0.437,32,61,0.525,6,26,0.231,9,12,0.75
1/2/2017,0,LAC,PHO,W ,109,98,240,37,80,0.463,30,64,0.469,7,16,0.438,28,38,0.737,39,102,0.382,37,87,0.425,2,15,0.133,18,22,0.818
1/2/2017,7,MIL,OKC,W ,98,94,240,38,79,0.481,31,60,0.517,7,19,0.368,15,24,0.625,36,78,0.462,27,51,0.529,9,27,0.333,13,19,0.684
1/2/2017,6,NYK,ORL,L ,103,115,240,39,83,0.47,31,62,0.5,8,21,0.381,17,24,0.708,45,91,0.495,30,60,0.5,15,31,0.484,10,14,0.714
1/1/2017,9,ATL,SAS,W ,114,112,265,42,92,0.457,28,64,0.438,14,28,0.5,16,27,0.593,42,90,0.467,33,63,0.524,9,27,0.333,19,22,0.864
1/1/2017,2,IND,ORL,W ,117,104,240,43,86,0.5,34,64,0.531,9,22,0.409,22,24,0.917,42,97,0.433,32,59,0.542,10,38,0.263,10,11,0.909
1/1/2017,8,LAL,TOR,L ,114,123,240,37,92,0.402,22,60,0.367,15,32,0.469,25,31,0.806,42,75,0.56,32,58,0.552,10,17,0.588,29,32,0.906
1/1/2017,5,MIA,DET,L ,98,107,240,35,77,0.455,21,51,0.412,14,26,0.538,14,18,0.778,42,86,0.488,33,64,0.516,9,22,0.409,14,22,0.636
1/1/2017,7,MIN,POR,L ,89,95,240,35,87,0.402,28,64,0.438,7,23,0.304,12,18,0.667,36,73,0.493,30,51,0.588,6,22,0.273,17,28,0.607
12/31/2016,7,CHI,MIL,L ,96,116,240,33,83,0.398,23,56,0.411,10,27,0.37,20,28,0.714,43,76,0.566,34,61,0.557,9,15,0.6,21,27,0.778
12/31/2016,5,CHO,CLE,L ,109,121,240,40,78,0.513,31,54,0.574,9,24,0.375,20,23,0.87,43,85,0.506,29,54,0.537,14,31,0.452,21,25,0.84
12/31/2016,1,HOU,NYK,W ,129,122,240,42,92,0.457,21,37,0.568,21,55,0.382,24,29,0.828,47,105,0.448,37,73,0.507,10,32,0.313,18,25,0.72
12/31/2016,1,OKC,LAC,W ,114,88,240,37,78,0.474,27,49,0.551,10,29,0.345,30,35,0.857,31,75,0.413,23,45,0.511,8,30,0.267,18,21,0.857
12/31/2016,7,SAC,MEM,L ,98,112,240,31,72,0.431,20,44,0.455,11,28,0.393,25,28,0.893,44,87,0.506,27,52,0.519,17,35,0.486,7,9,0.778
12/31/2016,20,UTA,PHO,W ,91,86,240,35,73,0.479,27,53,0.509,8,20,0.4,13,20,0.65,36,87,0.414,29,70,0.414,7,17,0.412,7,10,0.7
12/30/2016,5,ATL,DET,W ,105,98,240,39,88,0.443,31,62,0.5,8,26,0.308,19,25,0.76,35,84,0.417,26,53,0.491,9,31,0.29,19,21,0.905
12/30/2016,18,BOS,MIA,W ,117,114,240,38,74,0.514,21,42,0.5,17,32,0.531,24,29,0.828,48,90,0.533,37,62,0.597,11,28,0.393,7,10,0.7
12/30/2016,17,DEN,PHI,L ,122,124,240,39,84,0.464,28,57,0.491,11,27,0.407,33,41,0.805,38,87,0.437,22,54,0.407,16,33,0.485,32,40,0.8
12/30/2016,9,GSW,DAL,W ,108,99,240,42,84,0.5,31,51,0.608,11,33,0.333,13,15,0.867,39,93,0.419,31,61,0.508,8,32,0.25,13,15,0.867
12/30/2016,5,HOU,LAC,W ,140,116,240,45,81,0.556,31,41,0.756,14,40,0.35,36,43,0.837,45,96,0.469,32,63,0.508,13,33,0.394,13,16,0.813
12/30/2016,0,IND,CHI,W ,111,101,240,39,81,0.481,32,62,0.516,7,19,0.368,26,30,0.867,35,84,0.417,29,61,0.475,6,23,0.261,25,31,0.806
12/30/2016,0,MIN,MIL,W ,116,99,240,43,77,0.558,30,52,0.577,13,25,0.52,17,21,0.81,40,74,0.541,32,56,0.571,8,18,0.444,11,17,0.647
12/30/2016,2,NOP,NYK,W ,104,92,240,38,85,0.447,26,56,0.464,12,29,0.414,16,17,0.941,35,93,0.376,28,70,0.4,7,23,0.304,15,16,0.938
12/30/2016,4,SAS,POR,W ,110,94,240,39,78,0.5,28,56,0.5,11,22,0.5,21,25,0.84,35,77,0.455,29,57,0.509,6,20,0.3,18,21,0.857
12/30/2016,1,WAS,BRK,W ,118,95,240,47,83,0.566,36,61,0.59,11,22,0.5,13,14,0.929,32,74,0.432,22,49,0.449,10,25,0.4,21,25,0.84
12/29/2016,15,CHO,MIA,W ,91,82,240,36,93,0.387,31,67,0.463,5,26,0.192,14,18,0.778,33,82,0.402,23,54,0.426,10,28,0.357,6,13,0.462
12/29/2016,7,CLE,BOS,W ,124,118,240,43,83,0.518,29,45,0.644,14,38,0.368,24,33,0.727,43,85,0.506,31,48,0.646,12,37,0.324,20,21,0.952
12/29/2016,2,LAL,DAL,L ,89,101,240,32,68,0.471,25,49,0.51,7,19,0.368,18,25,0.72,38,77,0.494,24,46,0.522,14,31,0.452,11,14,0.786
12/29/2016,2,MEM,OKC,W ,114,80,240,43,82,0.524,30,60,0.5,13,22,0.591,15,20,0.75,25,74,0.338,21,52,0.404,4,22,0.182,26,38,0.684
12/29/2016,12,PHO,TOR,W ,99,91,240,37,83,0.446,28,62,0.452,9,21,0.429,16,23,0.696,30,75,0.4,23,48,0.479,7,27,0.259,24,29,0.828
12/29/2016,16,UTA,PHI,W ,100,83,240,35,73,0.479,20,47,0.426,15,26,0.577,15,28,0.536,35,87,0.402,29,63,0.46,6,24,0.25,7,8,0.875
12/28/2016,16,ATL,NYK,W ,102,98,265,37,101,0.366,30,74,0.405,7,27,0.259,21,27,0.778,35,93,0.376,28,66,0.424,7,27,0.259,21,26,0.808
12/28/2016,9,CHI,BRK,W ,101,99,240,35,88,0.398,32,75,0.427,3,13,0.231,28,29,0.966,37,86,0.43,24,54,0.444,13,32,0.406,12,16,0.75
12/28/2016,9,DEN,MIN,W ,105,103,240,42,81,0.519,32,53,0.604,10,28,0.357,11,14,0.786,42,94,0.447,35,69,0.507,7,25,0.28,12,17,0.706
12/28/2016,12,DET,MIL,L ,94,119,240,39,88,0.443,33,64,0.516,6,24,0.25,10,16,0.625,48,84,0.571,37,62,0.597,11,22,0.5,12,16,0.75
12/28/2016,0,GSW,TOR,W ,121,111,240,46,81,0.568,32,58,0.552,14,23,0.609,15,18,0.833,40,103,0.388,27,68,0.397,13,35,0.371,18,22,0.818
12/28/2016,8,NOP,LAC,W ,102,98,240,40,87,0.46,30,58,0.517,10,29,0.345,12,21,0.571,37,94,0.394,26,57,0.456,11,37,0.297,13,18,0.722
12/28/2016,5,ORL,CHO,L ,101,120,240,42,86,0.488,33,52,0.635,9,34,0.265,8,10,0.8,46,84,0.548,36,60,0.6,10,24,0.417,18,19,0.947
12/28/2016,7,POR,SAC,W ,102,89,240,35,74,0.473,23,49,0.469,12,25,0.48,20,22,0.909,31,79,0.392,22,51,0.431,9,28,0.321,18,23,0.783
12/28/2016,8,SAS,PHO,W ,119,98,240,47,87,0.54,42,70,0.6,5,17,0.294,20,25,0.8,36,74,0.486,29,58,0.5,7,16,0.438,19,24,0.792
12/28/2016,9,WAS,IND,W ,111,105,240,38,78,0.487,30,56,0.536,8,22,0.364,27,37,0.73,35,79,0.443,24,51,0.471,11,28,0.393,24,29,0.828
12/27/2016,8,BOS,MEM,W ,113,103,240,41,85,0.482,29,54,0.537,12,31,0.387,19,21,0.905,37,88,0.42,28,58,0.483,9,30,0.3,20,29,0.69
12/27/2016,2,DAL,HOU,L ,107,123,240,36,87,0.414,21,49,0.429,15,38,0.395,20,25,0.8,41,78,0.526,24,46,0.522,17,32,0.531,24,28,0.857
12/27/2016,18,LAL,UTA,L ,100,102,240,39,83,0.47,35,67,0.522,4,16,0.25,18,22,0.818,38,75,0.507,29,49,0.592,9,26,0.346,17,24,0.708
12/27/2016,1,MIA,OKC,L ,94,106,240,36,82,0.439,29,60,0.483,7,22,0.318,15,21,0.714,42,82,0.512,37,63,0.587,5,19,0.263,17,25,0.68
12/26/2016,12,BRK,CHO,W ,120,118,240,40,75,0.533,25,44,0.568,15,31,0.484,25,31,0.806,44,94,0.468,36,68,0.529,8,26,0.308,22,25,0.88
12/26/2016,1,CHI,IND,W ,90,85,240,32,83,0.386,26,58,0.448,6,25,0.24,20,28,0.714,34,81,0.42,25,56,0.446,9,25,0.36,8,10,0.8
12/26/2016,0,DET,CLE,W ,106,90,240,41,92,0.446,25,64,0.391,16,28,0.571,8,15,0.533,30,79,0.38,19,51,0.373,11,28,0.393,19,23,0.826
12/26/2016,0,HOU,PHO,W ,131,115,240,46,92,0.5,31,49,0.633,15,43,0.349,24,30,0.8,43,101,0.426,36,71,0.507,7,30,0.233,22,27,0.815
12/26/2016,13,LAC,DEN,L ,102,106,240,39,84,0.464,30,59,0.508,9,25,0.36,15,20,0.75,36,82,0.439,25,51,0.49,11,31,0.355,23,28,0.821
12/26/2016,5,MIN,ATL,W ,104,90,240,37,82,0.451,22,51,0.431,15,31,0.484,15,18,0.833,35,83,0.422,27,51,0.529,8,32,0.25,12,17,0.706
12/26/2016,4,NOP,DAL,W ,111,104,240,37,70,0.529,25,45,0.556,12,25,0.48,25,30,0.833,37,75,0.493,24,43,0.558,13,32,0.406,17,22,0.773
12/26/2016,0,ORL,MEM,W ,112,102,240,44,86,0.512,31,60,0.517,13,26,0.5,11,16,0.688,35,76,0.461,25,51,0.49,10,25,0.4,22,28,0.786
12/26/2016,9,POR,TOR,L ,91,95,240,35,83,0.422,27,60,0.45,8,23,0.348,13,18,0.722,32,95,0.337,20,61,0.328,12,34,0.353,19,24,0.792
12/26/2016,10,SAC,PHI,W ,102,100,240,39,87,0.448,32,62,0.516,7,25,0.28,17,21,0.81,39,79,0.494,30,54,0.556,9,25,0.36,13,18,0.722
12/26/2016,15,WAS,MIL,W ,107,102,240,40,79,0.506,28,50,0.56,12,29,0.414,15,20,0.75,40,87,0.46,34,67,0.507,6,20,0.3,16,23,0.696
12/25/2016,5,CLE,GSW,W ,109,108,240,37,95,0.389,25,60,0.417,12,35,0.343,23,32,0.719,37,77,0.481,28,47,0.596,9,30,0.3,25,29,0.862
12/25/2016,1,LAL,LAC,W ,111,102,240,40,84,0.476,32,59,0.542,8,25,0.32,23,30,0.767,37,85,0.435,27,56,0.482,10,29,0.345,18,22,0.818
12/25/2016,4,NYK,BOS,L ,114,119,240,41,87,0.471,33,64,0.516,8,23,0.348,24,27,0.889,45,93,0.484,31,57,0.544,14,36,0.389,15,20,0.75
12/25/2016,11,OKC,MIN,W ,112,100,240,42,82,0.512,34,58,0.586,8,24,0.333,20,24,0.833,39,83,0.47,35,71,0.493,4,12,0.333,18,23,0.783
12/25/2016,2,SAS,CHI,W ,119,100,240,48,85,0.565,39,67,0.582,9,18,0.5,14,19,0.737,39,86,0.453,32,68,0.471,7,18,0.389,15,20,0.75
12/23/2016,10,BOS,OKC,L ,112,117,240,41,93,0.441,32,65,0.492,9,28,0.321,21,26,0.808,41,80,0.513,30,54,0.556,11,26,0.423,24,36,0.667
12/23/2016,4,CHO,CHI,W ,103,91,240,37,84,0.44,32,66,0.485,5,18,0.278,24,28,0.857,38,96,0.396,31,74,0.419,7,22,0.318,8,10,0.8
12/23/2016,0,CLE,BRK,W ,119,99,240,45,99,0.455,37,64,0.578,8,35,0.229,21,24,0.875,38,85,0.447,30,55,0.545,8,30,0.267,15,18,0.833
12/23/2016,10,DEN,ATL,L ,108,109,240,37,78,0.474,29,53,0.547,8,25,0.32,26,35,0.743,37,86,0.43,29,61,0.475,8,25,0.32,27,33,0.818
12/23/2016,18,DET,GSW,L ,113,119,240,43,85,0.506,33,56,0.589,10,29,0.345,17,28,0.607,43,77,0.558,32,50,0.64,11,27,0.407,22,24,0.917
12/23/2016,12,LAC,DAL,L ,88,90,240,34,74,0.459,21,45,0.467,13,29,0.448,7,11,0.636,37,87,0.425,30,58,0.517,7,29,0.241,9,15,0.6
12/23/2016,5,MEM,HOU,W ,115,109,240,41,81,0.506,28,56,0.5,13,25,0.52,20,25,0.8,38,89,0.427,18,37,0.486,20,52,0.385,13,15,0.867
12/23/2016,4,MIL,WAS,W ,123,96,240,45,80,0.563,36,55,0.655,9,25,0.36,24,27,0.889,37,79,0.468,30,55,0.545,7,24,0.292,15,18,0.833
12/23/2016,20,MIN,SAC,L ,105,109,240,36,79,0.456,24,47,0.511,12,32,0.375,21,26,0.808,42,80,0.525,27,51,0.529,15,29,0.517,10,14,0.714
12/23/2016,9,NOP,MIA,W ,91,87,240,33,89,0.371,22,61,0.361,11,28,0.393,14,21,0.667,36,87,0.414,28,67,0.418,8,20,0.4,7,13,0.538
12/23/2016,0,ORL,LAL,W ,109,90,240,45,89,0.506,34,62,0.548,11,27,0.407,8,14,0.571,31,87,0.356,23,64,0.359,8,23,0.348,20,24,0.833
12/23/2016,7,PHO,PHI,W ,123,116,240,42,79,0.532,30,53,0.566,12,26,0.462,27,37,0.73,42,83,0.506,29,52,0.558,13,31,0.419,19,22,0.864
12/23/2016,7,POR,SAS,L ,90,110,240,35,79,0.443,23,49,0.469,12,30,0.4,8,16,0.5,39,78,0.5,27,58,0.466,12,20,0.6,20,21,0.952
12/23/2016,10,UTA,TOR,L ,98,104,240,35,79,0.443,25,52,0.481,10,27,0.37,18,21,0.857,43,81,0.531,35,60,0.583,8,21,0.381,10,15,0.667
12/22/2016,12,BRK,GSW,L ,101,117,240,38,86,0.442,25,51,0.49,13,35,0.371,12,16,0.75,47,104,0.452,35,67,0.522,12,37,0.324,11,14,0.786
12/22/2016,6,IND,BOS,L ,102,109,240,35,82,0.427,28,59,0.475,7,23,0.304,25,29,0.862,38,92,0.413,28,53,0.528,10,39,0.256,23,27,0.852
12/22/2016,1,LAC,SAS,W ,106,101,240,39,83,0.47,28,55,0.509,11,28,0.393,17,22,0.773,37,92,0.402,31,73,0.425,6,19,0.316,21,25,0.84
12/22/2016,7,MIA,LAL,W ,115,107,240,45,84,0.536,34,62,0.548,11,22,0.5,14,21,0.667,40,90,0.444,26,52,0.5,14,38,0.368,13,15,0.867
12/22/2016,2,NYK,ORL,W ,106,95,240,41,96,0.427,32,76,0.421,9,20,0.45,15,17,0.882,39,90,0.433,34,63,0.54,5,27,0.185,12,16,0.75
12/21/2016,12,ATL,MIN,L ,84,92,240,34,82,0.415,27,56,0.482,7,26,0.269,9,13,0.692,35,83,0.422,26,54,0.481,9,29,0.31,13,14,0.929
12/21/2016,17,CHI,WAS,L ,97,107,240,38,95,0.4,32,74,0.432,6,21,0.286,15,19,0.789,43,82,0.524,40,64,0.625,3,18,0.167,18,25,0.72
12/21/2016,1,CLE,MIL,W ,113,102,240,43,87,0.494,28,60,0.467,15,27,0.556,12,19,0.632,36,77,0.468,27,55,0.491,9,22,0.409,21,29,0.724
12/21/2016,8,DET,MEM,L ,86,98,240,26,72,0.361,20,49,0.408,6,23,0.261,28,37,0.757,35,82,0.427,23,52,0.442,12,30,0.4,16,19,0.842
12/21/2016,13,NOP,OKC,L ,110,121,240,42,88,0.477,34,68,0.5,8,20,0.4,18,23,0.783,45,88,0.511,34,60,0.567,11,28,0.393,20,24,0.833
12/21/2016,2,PHO,HOU,L ,111,125,240,44,93,0.473,35,68,0.515,9,25,0.36,14,20,0.7,46,86,0.535,28,48,0.583,18,38,0.474,15,26,0.577
12/21/2016,1,POR,DAL,L ,95,96,240,32,72,0.444,22,45,0.489,10,27,0.37,21,28,0.75,35,83,0.422,28,52,0.538,7,31,0.226,19,23,0.826
12/21/2016,2,UTA,SAC,L ,93,94,240,33,74,0.446,24,47,0.511,9,27,0.333,18,22,0.818,34,74,0.459,24,53,0.453,10,21,0.476,16,24,0.667
12/20/2016,8,CHO,LAL,W ,117,113,240,43,94,0.457,32,69,0.464,11,25,0.44,20,24,0.833,44,90,0.489,28,57,0.491,16,33,0.485,9,11,0.818
12/20/2016,2,GSW,UTA,W ,104,74,240,40,90,0.444,31,67,0.463,9,23,0.391,15,17,0.882,27,76,0.355,18,46,0.391,9,30,0.3,11,20,0.55
12/20/2016,8,HOU,SAS,L ,100,102,240,35,92,0.38,29,54,0.537,6,38,0.158,24,27,0.889,36,77,0.468,24,54,0.444,12,23,0.522,18,25,0.72
12/20/2016,0,LAC,DEN,W ,119,102,240,47,86,0.547,31,50,0.62,16,36,0.444,9,13,0.692,39,90,0.433,28,51,0.549,11,39,0.282,13,20,0.65
12/20/2016,10,MEM,BOS,L ,109,112,265,38,94,0.404,26,64,0.406,12,30,0.4,21,26,0.808,33,81,0.407,21,44,0.477,12,37,0.324,34,38,0.895
12/20/2016,27,MIA,ORL,L ,130,136,290,50,108,0.463,38,78,0.487,12,30,0.4,18,26,0.692,52,105,0.495,41,83,0.494,11,22,0.5,21,31,0.677
12/20/2016,11,MIL,CLE,L ,108,114,265,40,87,0.46,33,60,0.55,7,27,0.259,21,29,0.724,37,91,0.407,20,51,0.392,17,40,0.425,23,27,0.852
12/20/2016,6,NYK,IND,W ,118,111,240,44,88,0.5,31,65,0.477,13,23,0.565,17,21,0.81,39,91,0.429,33,68,0.485,6,23,0.261,27,33,0.818
12/20/2016,2,PHI,NOP,L ,93,108,240,33,82,0.402,22,49,0.449,11,33,0.333,16,21,0.762,40,93,0.43,30,76,0.395,10,17,0.588,18,26,0.692
12/20/2016,7,SAC,POR,W ,126,121,240,40,72,0.556,30,49,0.612,10,23,0.435,36,43,0.837,44,86,0.512,40,58,0.69,4,28,0.143,29,40,0.725
12/20/2016,0,TOR,BRK,W ,116,104,240,42,91,0.462,34,73,0.466,8,18,0.444,24,31,0.774,36,91,0.396,26,56,0.464,10,35,0.286,22,28,0.786
12/19/2016,0,CHI,DET,W ,113,82,240,49,82,0.598,41,66,0.621,8,16,0.5,7,7,1,34,83,0.41,31,60,0.517,3,23,0.13,11,13,0.846
12/19/2016,13,DEN,DAL,W ,117,107,240,45,80,0.563,32,55,0.582,13,25,0.52,14,18,0.778,43,80,0.538,29,55,0.527,14,25,0.56,7,9,0.778
12/19/2016,5,IND,WAS,W ,107,105,240,41,87,0.471,34,66,0.515,7,21,0.333,18,21,0.857,38,88,0.432,30,55,0.545,8,33,0.242,21,26,0.808
12/19/2016,1,MIN,PHO,W ,115,108,240,42,86,0.488,35,67,0.522,7,19,0.368,24,25,0.96,37,82,0.451,28,61,0.459,9,21,0.429,25,35,0.714
12/19/2016,16,OKC,ATL,L ,108,110,240,39,87,0.448,29,52,0.558,10,35,0.286,20,26,0.769,41,75,0.547,32,52,0.615,9,23,0.391,19,24,0.792
12/18/2016,0,DAL,SAC,W ,99,79,240,34,77,0.442,21,44,0.477,13,33,0.394,18,22,0.818,30,76,0.395,22,45,0.489,8,31,0.258,11,17,0.647
12/18/2016,14,MEM,UTA,L ,73,82,240,28,93,0.301,26,70,0.371,2,23,0.087,15,18,0.833,30,66,0.455,22,39,0.564,8,27,0.296,14,25,0.56
12/18/2016,4,MIA,BOS,L ,95,105,240,36,69,0.522,27,45,0.6,9,24,0.375,14,25,0.56,41,90,0.456,32,62,0.516,9,28,0.321,14,19,0.737
12/18/2016,2,ORL,TOR,L ,79,109,240,34,83,0.41,31,62,0.5,3,21,0.143,8,9,0.889,43,87,0.494,36,60,0.6,7,27,0.259,16,21,0.762
12/18/2016,21,PHI,BRK,W ,108,107,240,38,88,0.432,26,60,0.433,12,28,0.429,20,23,0.87,36,81,0.444,24,47,0.511,12,34,0.353,23,31,0.742
12/18/2016,10,SAS,NOP,W ,113,100,240,42,86,0.488,31,64,0.484,11,22,0.5,18,22,0.818,41,89,0.461,31,63,0.492,10,26,0.385,8,14,0.571
12/18/2016,12,WAS,LAC,W ,117,110,240,43,81,0.531,33,62,0.532,10,19,0.526,21,30,0.7,43,87,0.494,36,63,0.571,7,24,0.292,17,24,0.708
12/17/2016,7,ATL,CHO,L ,99,107,240,40,86,0.465,30,60,0.5,10,26,0.385,9,16,0.563,43,88,0.489,31,61,0.508,12,27,0.444,9,13,0.692
12/17/2016,2,CLE,LAL,W ,119,108,240,46,89,0.517,31,56,0.554,15,33,0.455,12,18,0.667,41,86,0.477,25,49,0.51,16,37,0.432,10,13,0.769
12/17/2016,0,DEN,NYK,W ,127,114,240,50,90,0.556,40,63,0.635,10,27,0.37,17,29,0.586,35,80,0.438,27,57,0.474,8,23,0.348,36,39,0.923
12/17/2016,2,DET,IND,L ,90,105,240,32,84,0.381,22,54,0.407,10,30,0.333,16,22,0.727,40,83,0.482,34,64,0.531,6,19,0.316,19,25,0.76
12/17/2016,0,GSW,POR,W ,135,90,240,51,87,0.586,37,59,0.627,14,28,0.5,19,26,0.731,34,86,0.395,26,58,0.448,8,28,0.286,14,20,0.7
12/17/2016,11,MIN,HOU,L ,109,111,265,41,92,0.446,34,71,0.479,7,21,0.333,20,27,0.741,39,96,0.406,22,45,0.489,17,51,0.333,16,20,0.8
12/17/2016,1,OKC,PHO,W ,114,101,240,41,81,0.506,34,65,0.523,7,16,0.438,25,34,0.735,39,90,0.433,31,68,0.456,8,22,0.364,15,20,0.75
12/16/2016,14,BOS,CHO,W ,96,88,240,34,78,0.436,25,50,0.5,9,28,0.321,19,26,0.731,32,97,0.33,24,67,0.358,8,30,0.267,16,19,0.842
12/16/2016,1,CHI,MIL,L ,69,95,240,28,92,0.304,23,71,0.324,5,21,0.238,8,15,0.533,38,82,0.463,28,57,0.491,10,25,0.4,9,13,0.692
12/16/2016,3,HOU,NOP,W ,122,100,240,42,94,0.447,18,33,0.545,24,61,0.393,14,19,0.737,40,98,0.408,31,71,0.437,9,27,0.333,11,20,0.55
12/16/2016,1,MEM,SAC,L ,92,96,240,29,77,0.377,24,52,0.462,5,25,0.2,29,36,0.806,31,80,0.388,24,56,0.429,7,24,0.292,27,37,0.73
12/16/2016,7,MIA,LAC,L ,98,102,240,38,93,0.409,32,66,0.485,6,27,0.222,16,25,0.64,36,83,0.434,29,58,0.5,7,25,0.28,23,29,0.793
12/16/2016,15,ORL,BRK,W ,118,111,240,39,97,0.402,32,68,0.471,7,29,0.241,33,42,0.786,39,83,0.47,28,56,0.5,11,27,0.407,22,26,0.846
12/16/2016,0,PHI,LAL,L ,89,100,240,32,88,0.364,26,57,0.456,6,31,0.194,19,24,0.792,36,79,0.456,27,49,0.551,9,30,0.3,19,22,0.864
12/16/2016,8,TOR,ATL,L ,121,125,240,47,86,0.547,37,65,0.569,10,21,0.476,17,26,0.654,46,86,0.535,35,61,0.574,11,25,0.44,22,32,0.688
12/16/2016,8,UTA,DAL,W ,103,100,240,37,65,0.569,29,43,0.674,8,22,0.364,21,27,0.778,35,77,0.455,23,49,0.469,12,28,0.429,18,21,0.857
12/16/2016,11,WAS,DET,W ,122,108,240,44,77,0.571,32,52,0.615,12,25,0.48,22,27,0.815,42,86,0.488,32,58,0.552,10,28,0.357,14,21,0.667
12/15/2016,0,DEN,POR,W ,132,120,240,43,84,0.512,28,53,0.528,15,31,0.484,31,35,0.886,41,88,0.466,33,65,0.508,8,23,0.348,30,36,0.833
12/15/2016,3,GSW,NYK,W ,103,90,240,45,96,0.469,36,64,0.563,9,32,0.281,4,8,0.5,38,93,0.409,33,72,0.458,5,21,0.238,9,19,0.474
12/15/2016,0,MIL,CHI,W ,108,97,240,45,95,0.474,34,75,0.453,11,20,0.55,7,13,0.538,35,74,0.473,30,54,0.556,5,20,0.25,22,29,0.759
12/15/2016,10,NOP,IND,W ,102,95,240,36,85,0.424,26,58,0.448,10,27,0.37,20,28,0.714,36,87,0.414,33,66,0.5,3,21,0.143,20,24,0.833
12/15/2016,9,PHO,SAS,L ,92,107,240,34,85,0.4,24,58,0.414,10,27,0.37,14,18,0.778,39,74,0.527,34,58,0.586,5,16,0.313,24,26,0.923
12/14/2016,18,BRK,LAL,W ,107,97,240,33,86,0.384,22,51,0.431,11,35,0.314,30,40,0.75,35,91,0.385,29,64,0.453,6,27,0.222,21,34,0.618
12/14/2016,12,DAL,DET,L ,85,95,240,32,78,0.41,24,53,0.453,8,25,0.32,13,16,0.813,36,71,0.507,31,54,0.574,5,17,0.294,18,22,0.818
12/14/2016,2,HOU,SAC,W ,132,98,240,50,85,0.588,28,43,0.651,22,42,0.524,10,16,0.625,39,92,0.424,28,60,0.467,11,32,0.344,9,11,0.818
12/14/2016,0,MEM,CLE,W ,93,85,240,35,81,0.432,23,58,0.397,12,23,0.522,11,16,0.688,28,75,0.373,19,50,0.38,9,25,0.36,20,31,0.645
12/14/2016,14,MIA,IND,W ,95,89,240,37,82,0.451,30,57,0.526,7,25,0.28,14,25,0.56,33,89,0.371,24,62,0.387,9,27,0.333,14,17,0.824
12/14/2016,4,ORL,LAC,L ,108,113,240,42,89,0.472,28,56,0.5,14,33,0.424,10,20,0.5,37,74,0.5,24,49,0.49,13,25,0.52,26,37,0.703
12/14/2016,7,PHI,TOR,L ,114,123,240,43,86,0.5,34,57,0.596,9,29,0.31,19,25,0.76,41,87,0.471,31,58,0.534,10,29,0.345,31,36,0.861
12/14/2016,7,SAS,BOS,W ,108,101,240,44,80,0.55,36,58,0.621,8,22,0.364,12,14,0.857,37,84,0.44,27,53,0.509,10,31,0.323,17,20,0.85
12/14/2016,0,UTA,OKC,W ,109,89,240,42,72,0.583,29,49,0.592,13,23,0.565,12,15,0.8,30,82,0.366,24,63,0.381,6,19,0.316,23,27,0.852
12/14/2016,8,WAS,CHO,W ,109,106,240,45,87,0.517,40,69,0.58,5,18,0.278,14,17,0.824,38,74,0.514,24,41,0.585,14,33,0.424,16,21,0.762
12/13/2016,9,ATL,ORL,L ,120,131,240,45,89,0.506,34,61,0.557,11,28,0.393,19,21,0.905,51,87,0.586,36,53,0.679,15,34,0.441,14,20,0.7
12/13/2016,5,CHI,MIN,L ,94,99,240,38,87,0.437,34,72,0.472,4,15,0.267,14,19,0.737,38,86,0.442,32,65,0.492,6,21,0.286,17,22,0.773
12/13/2016,3,CLE,MEM,W ,103,86,240,37,81,0.457,25,50,0.5,12,31,0.387,17,23,0.739,35,86,0.407,31,64,0.484,4,22,0.182,12,15,0.8
12/13/2016,13,NOP,GSW,L ,109,113,240,39,82,0.476,25,47,0.532,14,35,0.4,17,21,0.81,42,95,0.442,28,61,0.459,14,34,0.412,15,19,0.789
12/13/2016,11,PHO,NYK,W ,113,111,265,38,93,0.409,29,63,0.46,9,30,0.3,28,33,0.848,38,97,0.392,31,77,0.403,7,20,0.35,28,38,0.737
12/13/2016,1,POR,OKC,W ,114,95,240,43,80,0.538,35,57,0.614,8,23,0.348,20,27,0.741,33,87,0.379,25,60,0.417,8,27,0.296,21,28,0.75
12/12/2016,0,DAL,DEN,W ,112,92,240,45,77,0.584,33,51,0.647,12,26,0.462,10,12,0.833,35,83,0.422,28,58,0.483,7,25,0.28,15,18,0.833
12/12/2016,3,HOU,BRK,W ,122,118,240,42,91,0.462,25,48,0.521,17,43,0.395,21,36,0.583,42,80,0.525,35,60,0.583,7,20,0.35,27,36,0.75
12/12/2016,9,IND,CHO,W ,110,94,240,43,88,0.489,26,52,0.5,17,36,0.472,7,10,0.7,28,84,0.333,18,58,0.31,10,26,0.385,28,32,0.875
12/12/2016,12,LAC,POR,W ,121,120,240,42,89,0.472,31,66,0.47,11,23,0.478,26,28,0.929,44,87,0.506,34,66,0.515,10,21,0.476,22,25,0.88
12/12/2016,11,MIA,WAS,W ,112,101,240,45,88,0.511,36,62,0.581,9,26,0.346,13,19,0.684,39,84,0.464,34,61,0.557,5,23,0.217,18,22,0.818
12/12/2016,5,SAC,LAL,W ,116,92,240,47,84,0.56,37,61,0.607,10,23,0.435,12,21,0.571,33,84,0.393,23,61,0.377,10,23,0.435,16,21,0.762
12/12/2016,3,TOR,MIL,W ,122,100,240,42,81,0.519,28,56,0.5,14,25,0.56,24,28,0.857,42,89,0.472,38,65,0.585,4,24,0.167,12,17,0.706
12/11/2016,0,DET,PHI,L ,79,97,240,32,82,0.39,27,63,0.429,5,19,0.263,10,14,0.714,38,68,0.559,31,51,0.608,7,17,0.412,14,17,0.824
12/11/2016,10,LAL,NYK,L ,112,118,240,42,88,0.477,32,60,0.533,10,28,0.357,18,22,0.818,41,84,0.488,31,62,0.5,10,22,0.455,26,31,0.839
12/11/2016,16,MIN,GSW,L ,108,116,240,36,81,0.444,27,57,0.474,9,24,0.375,27,36,0.75,38,83,0.458,25,51,0.49,13,32,0.406,27,30,0.9
12/11/2016,11,OKC,BOS,W ,99,96,240,41,83,0.494,38,62,0.613,3,21,0.143,14,27,0.519,40,90,0.444,29,58,0.5,11,32,0.344,5,8,0.625
12/11/2016,6,PHO,NOP,L ,119,120,265,44,96,0.458,30,55,0.545,14,41,0.341,17,26,0.654,38,97,0.392,22,57,0.386,16,40,0.4,28,35,0.8
12/10/2016,10,CHI,MIA,W ,105,100,240,38,84,0.452,37,76,0.487,1,8,0.125,28,31,0.903,42,91,0.462,37,71,0.521,5,20,0.25,11,18,0.611
12/10/2016,5,CLE,CHO,W ,116,105,240,42,73,0.575,29,42,0.69,13,31,0.419,19,28,0.679,39,86,0.453,29,59,0.492,10,27,0.37,17,24,0.708
12/10/2016,3,HOU,DAL,W ,109,87,240,37,74,0.5,18,37,0.486,19,37,0.514,16,22,0.727,32,79,0.405,21,45,0.467,11,34,0.324,12,14,0.857
12/10/2016,3,IND,POR,W ,118,111,240,40,83,0.482,25,54,0.463,15,29,0.517,23,28,0.821,40,82,0.488,24,45,0.533,16,37,0.432,15,16,0.938
12/10/2016,7,LAC,NOP,W ,133,105,240,54,94,0.574,37,58,0.638,17,36,0.472,8,9,0.889,40,83,0.482,32,64,0.5,8,19,0.421,17,26,0.654
12/10/2016,2,MEM,GSW,W ,110,89,240,38,87,0.437,30,61,0.492,8,26,0.308,26,29,0.897,34,77,0.442,25,50,0.5,9,27,0.333,12,20,0.6
12/10/2016,12,ORL,DEN,L ,113,121,240,43,88,0.489,32,61,0.525,11,27,0.407,16,24,0.667,47,83,0.566,39,64,0.609,8,19,0.421,19,25,0.76
12/10/2016,1,SAS,BRK,W ,130,101,240,50,94,0.532,36,68,0.529,14,26,0.538,16,18,0.889,36,87,0.414,29,60,0.483,7,27,0.259,22,25,0.88
12/10/2016,9,UTA,SAC,W ,104,84,240,37,77,0.481,24,48,0.5,13,29,0.448,17,18,0.944,34,90,0.378,25,64,0.391,9,26,0.346,7,13,0.538
12/10/2016,14,WAS,MIL,W ,110,105,240,40,88,0.455,32,67,0.478,8,21,0.381,22,28,0.786,40,79,0.506,27,54,0.5,13,25,0.52,12,15,0.8
12/9/2016,9,BOS,TOR,L ,94,101,240,31,83,0.373,14,41,0.341,17,42,0.405,15,22,0.682,34,82,0.415,25,62,0.403,9,20,0.45,24,27,0.889
12/9/2016,4,CHO,ORL,W ,109,88,240,41,85,0.482,32,63,0.508,9,22,0.409,18,23,0.783,34,91,0.374,25,57,0.439,9,34,0.265,11,14,0.786
12/9/2016,7,CLE,MIA,W ,114,84,240,46,83,0.554,37,59,0.627,9,24,0.375,13,19,0.684,31,90,0.344,25,63,0.397,6,27,0.222,16,21,0.762
12/9/2016,9,DAL,IND,W ,111,103,240,39,80,0.488,24,48,0.5,15,32,0.469,18,24,0.75,32,69,0.464,18,44,0.409,14,25,0.56,25,26,0.962
12/9/2016,9,LAL,PHO,L ,115,119,240,40,87,0.46,31,61,0.508,9,26,0.346,26,34,0.765,45,95,0.474,32,65,0.492,13,30,0.433,16,21,0.762
12/9/2016,9,MIL,ATL,L ,110,114,240,44,94,0.468,32,66,0.485,12,28,0.429,10,14,0.714,40,84,0.476,28,50,0.56,12,34,0.353,22,29,0.759
12/9/2016,8,MIN,DET,L ,90,117,240,37,78,0.474,34,62,0.548,3,16,0.188,13,20,0.65,42,84,0.5,28,55,0.509,14,29,0.483,19,23,0.826
12/9/2016,6,OKC,HOU,L ,99,102,240,34,81,0.42,27,53,0.509,7,28,0.25,24,31,0.774,36,92,0.391,25,50,0.5,11,42,0.262,19,30,0.633
12/9/2016,17,SAC,NYK,L ,100,103,240,35,87,0.402,28,59,0.475,7,28,0.25,23,27,0.852,36,84,0.429,26,55,0.473,10,29,0.345,21,25,0.84
12/8/2016,0,CHI,SAS,W ,95,91,240,35,80,0.438,31,63,0.492,4,17,0.235,21,27,0.778,39,97,0.402,30,69,0.435,9,28,0.321,4,5,0.8
12/8/2016,10,MEM,POR,W ,88,86,240,31,87,0.356,25,67,0.373,6,20,0.3,20,30,0.667,25,82,0.305,18,54,0.333,7,28,0.25,29,40,0.725
12/8/2016,5,NOP,PHI,L ,88,99,240,33,84,0.393,26,59,0.441,7,25,0.28,15,22,0.682,39,91,0.429,27,51,0.529,12,40,0.3,9,13,0.692
12/8/2016,11,TOR,MIN,W ,124,110,240,43,87,0.494,31,60,0.517,12,27,0.444,26,33,0.788,45,88,0.511,36,60,0.6,9,28,0.321,11,15,0.733
12/8/2016,1,UTA,GSW,L ,99,106,240,37,89,0.416,27,51,0.529,10,38,0.263,15,21,0.714,39,80,0.488,27,51,0.529,12,29,0.414,16,23,0.696
12/8/2016,6,WAS,DEN,W ,92,85,240,35,78,0.449,29,59,0.492,6,19,0.316,16,17,0.941,31,76,0.408,24,44,0.545,7,32,0.219,16,24,0.667
12/7/2016,2,ATL,MIA,W ,103,95,240,43,88,0.489,39,69,0.565,4,19,0.211,13,15,0.867,34,80,0.425,23,53,0.434,11,27,0.407,16,20,0.8
12/7/2016,0,BRK,DEN,W ,116,111,240,41,85,0.482,32,59,0.542,9,26,0.346,25,31,0.806,42,105,0.4,31,68,0.456,11,37,0.297,16,21,0.762
12/7/2016,15,CHO,DET,W ,87,77,240,30,88,0.341,24,67,0.358,6,21,0.286,21,29,0.724,34,89,0.382,30,62,0.484,4,27,0.148,5,8,0.625
12/7/2016,7,DAL,SAC,L ,89,120,240,32,78,0.41,22,48,0.458,10,30,0.333,15,20,0.75,47,84,0.56,37,62,0.597,10,22,0.455,16,21,0.762
12/7/2016,1,HOU,LAL,W ,134,95,240,51,94,0.543,36,58,0.621,15,36,0.417,17,21,0.81,34,87,0.391,29,67,0.433,5,20,0.25,22,27,0.815
12/7/2016,7,LAC,GSW,L ,98,115,240,36,92,0.391,28,66,0.424,8,26,0.308,18,24,0.75,42,89,0.472,35,58,0.603,7,31,0.226,24,29,0.828
12/7/2016,7,MIL,POR,W ,115,107,240,40,77,0.519,30,53,0.566,10,24,0.417,25,37,0.676,37,85,0.435,20,45,0.444,17,40,0.425,16,19,0.842
12/7/2016,0,NYK,CLE,L ,94,126,240,35,87,0.402,24,56,0.429,11,31,0.355,13,15,0.867,39,80,0.488,17,40,0.425,22,40,0.55,26,31,0.839
12/7/2016,7,ORL,BOS,L ,87,117,240,30,81,0.37,19,55,0.345,11,26,0.423,16,24,0.667,43,84,0.512,36,58,0.621,7,26,0.269,24,29,0.828
12/7/2016,14,PHO,IND,L ,94,109,240,34,85,0.4,25,52,0.481,9,33,0.273,17,18,0.944,35,78,0.449,28,55,0.509,7,23,0.304,32,41,0.78
12/6/2016,10,DET,CHI,W ,102,91,240,40,88,0.455,32,67,0.478,8,21,0.381,14,21,0.667,33,75,0.44,31,60,0.517,2,15,0.133,23,32,0.719
12/6/2016,11,MEM,PHI,W ,96,91,240,33,86,0.384,31,69,0.449,2,17,0.118,28,35,0.8,32,82,0.39,18,41,0.439,14,41,0.341,13,26,0.5
12/6/2016,19,MIA,NYK,L ,103,114,240,38,89,0.427,27,64,0.422,11,25,0.44,16,27,0.593,48,98,0.49,41,73,0.562,7,25,0.28,11,16,0.688
12/6/2016,5,MIN,SAS,L ,91,105,240,36,82,0.439,29,62,0.468,7,20,0.35,12,18,0.667,39,74,0.527,28,50,0.56,11,24,0.458,16,19,0.842
12/6/2016,0,UTA,PHO,W ,112,105,240,36,73,0.493,24,46,0.522,12,27,0.444,28,32,0.875,39,84,0.464,33,66,0.5,6,18,0.333,21,25,0.84
12/6/2016,8,WAS,ORL,L ,116,124,240,44,93,0.473,33,70,0.471,11,23,0.478,17,24,0.708,43,83,0.518,31,57,0.544,12,26,0.462,26,36,0.722
12/5/2016,11,ATL,OKC,L ,99,102,240,34,77,0.442,27,55,0.491,7,22,0.318,24,32,0.75,37,80,0.463,27,49,0.551,10,31,0.323,18,28,0.643
12/5/2016,6,BRK,WAS,L ,113,118,240,40,81,0.494,29,54,0.537,11,27,0.407,22,30,0.733,45,92,0.489,31,58,0.534,14,34,0.412,14,18,0.778
12/5/2016,13,CHI,POR,L ,110,112,240,35,83,0.422,28,60,0.467,7,23,0.304,33,38,0.868,45,93,0.484,36,69,0.522,9,24,0.375,13,18,0.722
12/5/2016,18,DAL,CHO,L ,101,109,240,37,89,0.416,24,53,0.453,13,36,0.361,14,18,0.778,40,79,0.506,37,61,0.607,3,18,0.167,26,28,0.929
12/5/2016,2,GSW,IND,W ,142,106,240,54,104,0.519,40,67,0.597,14,37,0.378,20,26,0.769,35,85,0.412,32,70,0.457,3,15,0.2,33,35,0.943
12/5/2016,6,HOU,BOS,W ,107,106,240,34,76,0.447,22,38,0.579,12,38,0.316,27,31,0.871,42,99,0.424,31,67,0.463,11,32,0.344,11,12,0.917
12/5/2016,10,LAL,UTA,L ,101,107,240,39,87,0.448,34,73,0.466,5,14,0.357,18,23,0.783,38,80,0.475,25,48,0.521,13,32,0.406,18,29,0.621
12/5/2016,21,MIL,SAS,L ,96,97,240,30,73,0.411,24,49,0.49,6,24,0.25,30,34,0.882,40,93,0.43,32,65,0.492,8,28,0.286,9,14,0.643
12/5/2016,12,NOP,MEM,L ,108,110,290,39,99,0.394,29,67,0.433,10,32,0.313,20,21,0.952,42,104,0.404,29,70,0.414,13,34,0.382,13,21,0.619
12/5/2016,3,PHI,DEN,L ,98,106,240,35,86,0.407,24,55,0.436,11,31,0.355,17,23,0.739,35,76,0.461,25,49,0.51,10,27,0.37,26,34,0.765
12/5/2016,6,TOR,CLE,L ,112,116,240,38,88,0.432,25,56,0.446,13,32,0.406,23,27,0.852,40,84,0.476,26,52,0.5,14,32,0.438,22,27,0.815
12/4/2016,7,DET,ORL,L ,92,98,240,38,86,0.442,28,59,0.475,10,27,0.37,6,13,0.462,42,79,0.532,35,56,0.625,7,23,0.304,7,14,0.5
12/4/2016,3,LAC,IND,L ,102,111,240,36,81,0.444,26,51,0.51,10,30,0.333,20,28,0.714,39,79,0.494,34,65,0.523,5,14,0.357,28,35,0.8
12/4/2016,5,NYK,SAC,W ,106,98,240,39,88,0.443,28,59,0.475,11,29,0.379,17,24,0.708,31,97,0.32,22,69,0.319,9,28,0.321,27,31,0.871
12/4/2016,7,OKC,NOP,W ,101,92,240,41,89,0.461,35,61,0.574,6,28,0.214,13,26,0.5,36,98,0.367,30,70,0.429,6,28,0.214,14,19,0.737
12/3/2016,3,CHO,MIN,L ,120,125,265,44,101,0.436,30,65,0.462,14,36,0.389,18,26,0.692,48,106,0.453,38,79,0.481,10,27,0.37,19,22,0.864
12/3/2016,0,DAL,CHI,W ,107,82,240,40,87,0.46,27,56,0.482,13,31,0.419,14,18,0.778,32,71,0.451,29,58,0.5,3,13,0.231,15,21,0.714
12/3/2016,3,GSW,PHO,W ,138,109,240,49,78,0.628,35,57,0.614,14,21,0.667,26,34,0.765,41,91,0.451,30,59,0.508,11,32,0.344,16,21,0.762
12/3/2016,17,MEM,LAL,W ,103,100,240,41,88,0.466,31,58,0.534,10,30,0.333,11,15,0.733,35,81,0.432,28,60,0.467,7,21,0.333,23,29,0.793
12/3/2016,19,MIL,BRK,W ,112,103,240,40,85,0.471,34,61,0.557,6,24,0.25,26,36,0.722,34,91,0.374,23,50,0.46,11,41,0.268,24,33,0.727
12/3/2016,6,PHI,BOS,L ,106,107,240,35,76,0.461,20,43,0.465,15,33,0.455,21,26,0.808,38,76,0.5,30,50,0.6,8,26,0.308,23,29,0.793
12/3/2016,9,POR,MIA,W ,99,92,240,36,89,0.404,27,65,0.415,9,24,0.375,18,24,0.75,38,86,0.442,32,64,0.5,6,22,0.273,10,15,0.667
12/3/2016,2,TOR,ATL,W ,128,84,240,53,92,0.576,40,68,0.588,13,24,0.542,9,11,0.818,35,88,0.398,28,60,0.467,7,28,0.25,7,14,0.5
12/3/2016,9,UTA,DEN,W ,105,98,240,35,78,0.449,26,53,0.491,9,25,0.36,26,28,0.929,37,83,0.446,24,59,0.407,13,24,0.542,11,14,0.786
12/2/2016,2,ATL,DET,L ,85,121,240,32,88,0.364,26,64,0.406,6,24,0.25,15,20,0.75,48,89,0.539,31,60,0.517,17,29,0.586,8,12,0.667
12/2/2016,23,BOS,SAC,W ,97,92,240,36,88,0.409,25,60,0.417,11,28,0.393,14,15,0.933,33,88,0.375,27,62,0.435,6,26,0.231,20,25,0.8
12/2/2016,4,CHI,CLE,W ,111,105,240,47,96,0.49,44,78,0.564,3,18,0.167,14,17,0.824,45,83,0.542,35,57,0.614,10,26,0.385,5,10,0.5
12/2/2016,0,DEN,HOU,L ,110,128,240,46,104,0.442,37,73,0.507,9,31,0.29,9,16,0.563,45,88,0.511,28,51,0.549,17,37,0.459,21,25,0.84
12/2/2016,5,NOP,LAC,L ,96,114,240,39,85,0.459,34,65,0.523,5,20,0.25,13,21,0.619,45,88,0.511,35,64,0.547,10,24,0.417,14,16,0.875
12/2/2016,2,NYK,MIN,W ,118,114,240,41,86,0.477,29,55,0.527,12,31,0.387,24,30,0.8,41,88,0.466,31,60,0.517,10,28,0.357,22,24,0.917
12/2/2016,3,PHI,ORL,L ,88,105,240,36,95,0.379,27,63,0.429,9,32,0.281,7,10,0.7,37,78,0.474,24,52,0.462,13,26,0.5,18,26,0.692
12/2/2016,6,SAS,WAS,W ,107,105,240,39,80,0.488,31,60,0.517,8,20,0.4,21,33,0.636,41,81,0.506,34,70,0.486,7,11,0.636,16,18,0.889
12/2/2016,0,TOR,LAL,W ,113,80,240,45,83,0.542,33,54,0.611,12,29,0.414,11,13,0.846,32,93,0.344,26,67,0.388,6,26,0.231,10,17,0.588
12/1/2016,12,BRK,MIL,L ,93,111,240,34,89,0.382,22,49,0.449,12,40,0.3,13,16,0.813,36,80,0.45,21,46,0.457,15,34,0.441,24,29,0.828
12/1/2016,0,CHO,DAL,W ,97,87,240,35,74,0.473,30,56,0.536,5,18,0.278,22,31,0.71,32,86,0.372,23,55,0.418,9,31,0.29,14,18,0.778
12/1/2016,3,CLE,LAC,L ,94,113,240,28,69,0.406,19,45,0.422,9,24,0.375,29,39,0.744,42,89,0.472,29,58,0.5,13,31,0.419,16,24,0.667
12/1/2016,14,GSW,HOU,L ,127,132,290,43,104,0.413,31,60,0.517,12,44,0.273,29,37,0.784,48,108,0.444,34,64,0.531,14,44,0.318,22,30,0.733
12/1/2016,5,MEM,ORL,W ,95,94,240,33,79,0.418,26,61,0.426,7,18,0.389,22,28,0.786,33,74,0.446,27,50,0.54,6,24,0.25,22,31,0.71
12/1/2016,10,UTA,MIA,L ,110,111,240,40,73,0.548,23,43,0.535,17,30,0.567,13,17,0.765,44,86,0.512,36,67,0.537,8,19,0.421,15,19,0.789
11/30/2016,5,BOS,DET,L ,114,121,240,40,91,0.44,25,49,0.51,15,42,0.357,19,20,0.95,48,87,0.552,39,67,0.582,9,20,0.45,16,21,0.762
11/30/2016,14,CHI,LAL,L ,90,96,240,32,91,0.352,28,70,0.4,4,21,0.19,22,29,0.759,33,81,0.407,31,73,0.425,2,8,0.25,28,41,0.683
11/30/2016,4,DAL,SAS,L ,87,94,240,33,77,0.429,23,47,0.489,10,30,0.333,11,14,0.786,33,71,0.465,22,52,0.423,11,19,0.579,17,24,0.708
11/30/2016,6,DEN,MIA,L ,98,106,240,38,91,0.418,31,69,0.449,7,22,0.318,15,24,0.625,41,93,0.441,32,69,0.464,9,24,0.375,15,26,0.577
11/30/2016,5,MIN,NYK,L ,104,106,240,34,77,0.442,30,58,0.517,4,19,0.211,32,39,0.821,41,91,0.451,28,59,0.475,13,32,0.406,11,15,0.733
11/30/2016,5,OKC,WAS,W ,126,115,265,46,95,0.484,34,65,0.523,12,30,0.4,22,31,0.71,44,98,0.449,34,70,0.486,10,28,0.357,17,26,0.654
11/30/2016,12,PHO,ATL,W ,109,107,240,40,89,0.449,30,68,0.441,10,21,0.476,19,25,0.76,45,89,0.506,36,64,0.563,9,25,0.36,8,10,0.8
11/30/2016,5,POR,IND,W ,131,109,240,51,94,0.543,39,62,0.629,12,32,0.375,17,19,0.895,36,72,0.5,30,58,0.517,6,14,0.429,31,35,0.886
11/30/2016,15,TOR,MEM,W ,120,105,240,38,69,0.551,22,37,0.595,16,32,0.5,28,33,0.848,36,82,0.439,25,55,0.455,11,27,0.407,22,26,0.846
11/29/2016,7,BRK,LAC,W ,127,122,290,45,104,0.433,32,66,0.485,13,38,0.342,24,36,0.667,46,109,0.422,33,69,0.478,13,40,0.325,17,22,0.773
11/29/2016,2,CHO,DET,L ,89,112,240,31,78,0.397,22,51,0.431,9,27,0.333,18,21,0.857,45,92,0.489,33,64,0.516,12,28,0.429,10,11,0.909
11/29/2016,4,MIL,CLE,W ,118,101,240,46,86,0.535,39,67,0.582,7,19,0.368,19,23,0.826,32,75,0.427,18,36,0.5,14,39,0.359,23,31,0.742
11/29/2016,0,NOP,LAL,W ,105,88,240,38,88,0.432,30,57,0.526,8,31,0.258,21,25,0.84,37,87,0.425,32,57,0.561,5,30,0.167,9,18,0.5
11/29/2016,12,SAS,ORL,L ,83,95,240,28,76,0.368,23,56,0.411,5,20,0.25,22,26,0.846,39,86,0.453,33,71,0.465,6,15,0.4,11,12,0.917
11/29/2016,1,UTA,HOU,W ,120,101,240,41,74,0.554,26,46,0.565,15,28,0.536,23,27,0.852,37,91,0.407,26,61,0.426,11,30,0.367,16,22,0.727
11/28/2016,7,GSW,ATL,W ,105,100,240,37,85,0.435,25,50,0.5,12,35,0.343,19,24,0.792,36,85,0.424,29,56,0.518,7,29,0.241,21,30,0.7
11/28/2016,2,MEM,CHO,L ,85,104,240,36,89,0.404,29,60,0.483,7,29,0.241,6,13,0.462,36,82,0.439,27,56,0.482,9,26,0.346,23,31,0.742
11/28/2016,3,MIA,BOS,L ,104,112,240,38,80,0.475,32,50,0.64,6,30,0.2,22,32,0.688,40,83,0.482,29,56,0.518,11,27,0.407,21,26,0.808
11/28/2016,7,MIN,UTA,L ,103,112,240,36,81,0.444,29,62,0.468,7,19,0.368,24,25,0.96,40,79,0.506,36,61,0.59,4,18,0.222,28,34,0.824
11/28/2016,7,NYK,OKC,L ,103,112,240,36,91,0.396,30,72,0.417,6,19,0.316,25,28,0.893,46,92,0.5,38,70,0.543,8,22,0.364,12,18,0.667
11/28/2016,8,TOR,PHI,W ,122,95,240,42,77,0.545,29,58,0.5,13,19,0.684,25,31,0.806,36,86,0.419,22,52,0.423,14,34,0.412,9,13,0.692
11/28/2016,7,WAS,SAC,W ,101,95,265,35,85,0.412,25,60,0.417,10,25,0.4,21,26,0.808,38,93,0.409,35,72,0.486,3,21,0.143,16,26,0.615
11/27/2016,7,BRK,SAC,L ,105,122,240,38,87,0.437,22,47,0.468,16,40,0.4,13,14,0.929,46,86,0.535,33,63,0.524,13,23,0.565,17,22,0.773
11/27/2016,18,DAL,NOP,W ,91,81,240,32,77,0.416,22,50,0.44,10,27,0.37,17,20,0.85,30,77,0.39,25,57,0.439,5,20,0.25,16,18,0.889
11/27/2016,6,IND,LAC,W ,91,70,240,40,92,0.435,35,73,0.479,5,19,0.263,6,7,0.857,22,70,0.314,18,46,0.391,4,24,0.167,22,27,0.815
11/27/2016,2,LAL,ATL,W ,109,94,240,42,95,0.442,34,75,0.453,8,20,0.4,17,20,0.85,39,88,0.443,27,53,0.509,12,35,0.343,4,10,0.4
11/27/2016,11,ORL,MIL,L ,96,104,240,38,92,0.413,31,64,0.484,7,28,0.25,13,17,0.765,41,86,0.477,33,62,0.532,8,24,0.333,14,20,0.7
11/27/2016,3,PHI,CLE,L ,108,112,240,43,92,0.467,28,58,0.483,15,34,0.441,7,10,0.7,38,92,0.413,26,52,0.5,12,40,0.3,24,28,0.857
11/27/2016,6,PHO,DEN,L ,114,120,240,36,89,0.404,25,64,0.391,11,25,0.44,31,36,0.861,39,89,0.438,26,60,0.433,13,29,0.448,29,32,0.906
11/27/2016,12,POR,HOU,L ,114,130,240,40,83,0.482,28,50,0.56,12,33,0.364,22,29,0.759,46,82,0.561,29,46,0.63,17,36,0.472,21,28,0.75
11/26/2016,2,CHO,NYK,W ,107,102,240,35,80,0.438,27,58,0.466,8,22,0.364,29,42,0.69,37,99,0.374,25,67,0.373,12,32,0.375,16,20,0.8
11/26/2016,7,GSW,MIN,W ,115,102,240,45,81,0.556,34,59,0.576,11,22,0.5,14,17,0.824,41,89,0.461,31,54,0.574,10,35,0.286,10,12,0.833
11/26/2016,13,MIA,MEM,L ,107,110,240,40,81,0.494,29,50,0.58,11,31,0.355,16,24,0.667,37,73,0.507,28,48,0.583,9,25,0.36,27,33,0.818
11/26/2016,1,OKC,DET,W ,106,88,240,42,83,0.506,34,60,0.567,8,23,0.348,14,26,0.538,37,82,0.451,36,63,0.571,1,19,0.053,13,17,0.765
11/26/2016,7,WAS,SAS,L ,100,112,240,42,88,0.477,36,66,0.545,6,22,0.273,10,14,0.714,40,75,0.533,31,51,0.608,9,24,0.375,23,29,0.793
11/25/2016,11,BOS,SAS,L ,103,109,240,42,91,0.462,30,57,0.526,12,34,0.353,7,9,0.778,38,81,0.469,27,57,0.474,11,24,0.458,22,25,0.88
11/25/2016,1,CLE,DAL,W ,128,90,240,43,85,0.506,23,42,0.548,20,43,0.465,22,24,0.917,37,91,0.407,29,56,0.518,8,35,0.229,8,12,0.667
11/25/2016,10,DEN,OKC,L ,129,132,265,48,101,0.475,36,67,0.537,12,34,0.353,21,27,0.778,48,96,0.5,35,70,0.5,13,26,0.5,23,29,0.793
11/25/2016,4,DET,LAC,W ,108,97,240,47,90,0.522,38,71,0.535,9,19,0.474,5,7,0.714,35,73,0.479,28,52,0.538,7,21,0.333,20,26,0.769
11/25/2016,4,IND,BRK,W ,118,97,240,48,87,0.552,37,61,0.607,11,26,0.423,11,16,0.688,36,79,0.456,25,45,0.556,11,34,0.324,14,23,0.609
11/25/2016,1,LAL,GSW,L ,85,109,240,32,90,0.356,27,68,0.397,5,22,0.227,16,23,0.696,43,83,0.518,32,55,0.582,11,28,0.393,12,17,0.706
11/25/2016,0,MEM,MIA,L ,81,90,240,29,82,0.354,25,63,0.397,4,19,0.211,19,23,0.826,33,85,0.388,21,54,0.389,12,31,0.387,12,18,0.667
11/25/2016,4,MIL,TOR,L ,99,105,240,40,79,0.506,28,50,0.56,12,29,0.414,7,12,0.583,38,82,0.463,24,50,0.48,14,32,0.438,15,19,0.789
11/25/2016,22,NYK,CHO,W ,113,111,265,45,97,0.464,34,69,0.493,11,28,0.393,12,13,0.923,43,93,0.462,35,64,0.547,8,29,0.276,17,27,0.63
11/25/2016,2,ORL,WAS,L ,91,94,240,35,80,0.438,28,57,0.491,7,23,0.304,14,20,0.7,40,88,0.455,34,59,0.576,6,29,0.207,8,10,0.8
11/25/2016,0,PHI,CHI,L ,89,105,240,31,78,0.397,22,56,0.393,9,22,0.409,18,22,0.818,40,90,0.444,34,69,0.493,6,21,0.286,19,26,0.731
11/25/2016,6,PHO,MIN,L ,85,98,240,32,79,0.405,26,53,0.491,6,26,0.231,15,21,0.714,34,85,0.4,27,63,0.429,7,22,0.318,23,25,0.92
11/25/2016,3,POR,NOP,W ,119,104,240,47,100,0.47,35,68,0.515,12,32,0.375,13,17,0.765,36,76,0.474,23,53,0.434,13,23,0.565,19,29,0.655
11/25/2016,0,SAC,HOU,L ,104,117,240,39,80,0.488,30,48,0.625,9,32,0.281,17,21,0.81,40,85,0.471,19,35,0.543,21,50,0.42,16,20,0.8
11/25/2016,6,UTA,ATL,W ,95,68,240,35,80,0.438,25,46,0.543,10,34,0.294,15,18,0.833,26,83,0.313,18,58,0.31,8,25,0.32,8,12,0.667
11/23/2016,0,BRK,BOS,L ,92,111,240,34,86,0.395,24,55,0.436,10,31,0.323,14,22,0.636,45,98,0.459,30,60,0.5,15,38,0.395,6,8,0.75
11/23/2016,34,CHO,SAS,L ,114,119,240,45,89,0.506,34,69,0.493,11,20,0.55,13,18,0.722,44,86,0.512,31,55,0.564,13,31,0.419,18,20,0.9
11/23/2016,0,CLE,POR,W ,137,125,240,48,90,0.533,27,54,0.5,21,36,0.583,20,27,0.741,47,90,0.522,34,61,0.557,13,29,0.448,18,19,0.947
11/23/2016,3,DAL,LAC,L ,104,124,240,38,84,0.452,27,60,0.45,11,24,0.458,17,18,0.944,43,85,0.506,28,53,0.528,15,32,0.469,23,31,0.742
11/23/2016,1,DET,MIA,W ,107,84,240,40,81,0.494,34,62,0.548,6,19,0.316,21,25,0.84,27,75,0.36,20,49,0.408,7,26,0.269,23,30,0.767
11/23/2016,2,GSW,LAL,W ,149,106,240,53,86,0.616,34,50,0.68,19,36,0.528,24,35,0.686,40,93,0.43,32,73,0.438,8,20,0.4,18,22,0.818
11/23/2016,2,HOU,TOR,L ,102,115,240,38,78,0.487,24,36,0.667,14,42,0.333,12,12,1,43,88,0.489,31,65,0.477,12,23,0.522,17,21,0.81
11/23/2016,8,IND,ATL,L ,85,96,240,34,84,0.405,27,57,0.474,7,27,0.259,10,14,0.714,36,85,0.424,31,65,0.477,5,20,0.25,19,22,0.864
11/23/2016,4,NOP,MIN,W ,117,96,240,45,83,0.542,36,59,0.61,9,24,0.375,18,23,0.783,33,86,0.384,30,69,0.435,3,17,0.176,27,33,0.818
11/23/2016,8,ORL,PHO,L ,87,92,240,33,91,0.363,26,66,0.394,7,25,0.28,14,23,0.609,33,73,0.452,24,51,0.471,9,22,0.409,17,22,0.773
11/23/2016,4,PHI,MEM,L ,99,104,290,35,93,0.376,23,57,0.404,12,36,0.333,17,23,0.739,38,99,0.384,28,70,0.4,10,29,0.345,18,24,0.75
11/23/2016,3,SAC,OKC,W ,116,101,240,44,94,0.468,32,66,0.485,12,28,0.429,16,17,0.941,32,76,0.421,25,51,0.49,7,25,0.28,30,38,0.789
11/23/2016,0,UTA,DEN,W ,108,83,240,39,79,0.494,31,53,0.585,8,26,0.308,22,31,0.71,28,88,0.318,19,61,0.311,9,27,0.333,18,31,0.581
11/22/2016,3,ATL,NOP,L ,94,112,240,39,85,0.459,29,56,0.518,10,29,0.345,6,10,0.6,45,86,0.523,34,61,0.557,11,25,0.44,11,12,0.917
11/22/2016,3,DEN,CHI,W ,110,107,240,43,100,0.43,33,78,0.423,10,22,0.455,14,17,0.824,43,95,0.453,37,77,0.481,6,18,0.333,15,18,0.833
11/22/2016,14,LAL,OKC,W ,111,109,240,42,83,0.506,28,56,0.5,14,27,0.519,13,16,0.813,45,92,0.489,34,65,0.523,11,27,0.407,8,11,0.727
11/22/2016,22,NYK,POR,W ,107,103,240,45,96,0.469,36,67,0.537,9,29,0.31,8,8,1,38,86,0.442,32,64,0.5,6,22,0.273,21,26,0.808
11/21/2016,0,CHO,MEM,L ,90,105,240,30,73,0.411,21,42,0.5,9,31,0.29,21,33,0.636,40,84,0.476,28,58,0.483,12,26,0.462,13,17,0.765
11/21/2016,5,DET,HOU,L ,96,99,240,36,87,0.414,29,70,0.414,7,17,0.412,17,24,0.708,35,78,0.449,25,47,0.532,10,31,0.323,19,27,0.704
11/21/2016,1,IND,GSW,L ,83,120,240,33,103,0.32,27,80,0.338,6,23,0.261,11,12,0.917,40,90,0.444,27,54,0.5,13,36,0.361,27,32,0.844
11/21/2016,8,LAC,TOR,W ,123,115,240,39,74,0.527,29,49,0.592,10,25,0.4,35,42,0.833,40,80,0.5,32,61,0.525,8,19,0.421,27,32,0.844
11/21/2016,7,MIL,ORL,W ,93,89,240,35,86,0.407,27,57,0.474,8,29,0.276,15,21,0.714,32,77,0.416,25,52,0.481,7,25,0.28,18,24,0.75
11/21/2016,3,MIN,BOS,L ,93,99,240,36,86,0.419,32,62,0.516,4,24,0.167,17,25,0.68,38,84,0.452,26,46,0.565,12,38,0.316,11,14,0.786
11/21/2016,5,PHI,MIA,W ,101,94,240,37,78,0.474,26,52,0.5,11,26,0.423,16,20,0.8,34,88,0.386,27,57,0.474,7,31,0.226,19,28,0.679
11/21/2016,10,SAS,DAL,W ,96,91,240,35,75,0.467,27,55,0.491,8,20,0.4,18,25,0.72,35,74,0.473,27,47,0.574,8,27,0.296,13,20,0.65
11/21/2016,20,WAS,PHO,W ,106,101,240,37,91,0.407,27,63,0.429,10,28,0.357,22,34,0.647,39,91,0.429,28,64,0.438,11,27,0.407,12,15,0.8
11/20/2016,6,BRK,POR,L ,109,129,240,37,93,0.398,27,58,0.466,10,35,0.286,25,31,0.806,49,85,0.576,34,49,0.694,15,36,0.417,16,21,0.762
11/20/2016,1,DEN,UTA,W ,105,91,240,42,86,0.488,34,64,0.531,8,22,0.364,13,30,0.433,33,85,0.388,26,58,0.448,7,27,0.259,18,23,0.783
11/20/2016,6,LAL,CHI,L ,110,118,240,41,93,0.441,28,62,0.452,13,31,0.419,15,21,0.714,45,87,0.517,37,65,0.569,8,22,0.364,20,28,0.714
11/20/2016,5,NYK,ATL,W ,104,94,240,42,88,0.477,32,61,0.525,10,27,0.37,10,14,0.714,34,85,0.4,28,64,0.438,6,21,0.286,20,29,0.69
11/20/2016,4,OKC,IND,L ,111,115,265,44,101,0.436,34,65,0.523,10,36,0.278,13,18,0.722,40,89,0.449,29,67,0.433,11,22,0.5,24,31,0.774
11/20/2016,11,SAC,TOR,W ,102,99,240,36,81,0.444,25,54,0.463,11,27,0.407,19,25,0.76,34,85,0.4,25,61,0.41,9,24,0.375,22,24,0.917
11/19/2016,19,DET,BOS,L ,92,94,240,37,86,0.43,30,66,0.455,7,20,0.35,11,16,0.688,33,82,0.402,21,51,0.412,12,31,0.387,16,17,0.941
11/19/2016,5,HOU,UTA,W ,111,102,240,42,94,0.447,30,62,0.484,12,32,0.375,15,20,0.75,39,76,0.513,27,49,0.551,12,27,0.444,12,17,0.706
11/19/2016,5,LAC,CHI,W ,102,95,240,36,77,0.468,25,50,0.5,11,27,0.407,19,23,0.826,33,77,0.429,24,47,0.511,9,30,0.3,20,24,0.833
11/19/2016,12,MEM,MIN,W ,93,71,240,29,76,0.382,27,58,0.466,2,18,0.111,33,38,0.868,25,64,0.391,18,42,0.429,7,22,0.318,14,22,0.636
11/19/2016,13,MIL,GSW,L ,121,124,240,46,89,0.517,36,69,0.522,10,20,0.5,19,25,0.76,42,95,0.442,28,57,0.491,14,38,0.368,26,32,0.813
11/19/2016,12,NOP,CHO,W ,121,116,265,43,98,0.439,29,62,0.468,14,36,0.389,21,25,0.84,40,97,0.412,25,54,0.463,15,43,0.349,21,28,0.75
11/19/2016,6,ORL,DAL,W ,95,87,240,34,78,0.436,26,57,0.456,8,21,0.381,19,22,0.864,26,77,0.338,13,49,0.265,13,28,0.464,22,27,0.815
11/19/2016,0,PHI,PHO,W ,120,105,240,45,86,0.523,28,51,0.549,17,35,0.486,13,20,0.65,39,92,0.424,33,71,0.465,6,21,0.286,21,34,0.618
11/19/2016,19,WAS,MIA,L ,111,114,240,42,89,0.472,31,62,0.5,11,27,0.407,16,22,0.727,43,85,0.506,30,58,0.517,13,27,0.481,15,26,0.577
11/18/2016,1,BOS,GSW,L ,88,104,240,31,83,0.373,20,51,0.392,11,32,0.344,15,19,0.789,44,90,0.489,35,62,0.565,9,28,0.321,7,12,0.583
11/18/2016,19,CHO,ATL,W ,100,96,240,37,90,0.411,27,61,0.443,10,29,0.345,16,24,0.667,39,84,0.464,32,56,0.571,7,28,0.25,11,17,0.647
11/18/2016,3,CLE,DET,W ,104,81,240,40,83,0.482,29,58,0.5,11,25,0.44,13,14,0.929,29,93,0.312,23,74,0.311,6,19,0.316,17,20,0.85
11/18/2016,7,DAL,MEM,L ,64,80,240,21,73,0.288,16,48,0.333,5,25,0.2,17,22,0.773,31,77,0.403,22,52,0.423,9,25,0.36,9,12,0.75
11/18/2016,26,DEN,TOR,L ,111,113,265,39,83,0.47,35,58,0.603,4,25,0.16,29,39,0.744,43,94,0.457,35,71,0.493,8,23,0.348,19,31,0.613
11/18/2016,6,IND,PHO,L ,96,116,240,36,76,0.474,35,69,0.507,1,7,0.143,23,29,0.793,46,97,0.474,37,71,0.521,9,26,0.346,15,18,0.833
11/18/2016,4,LAL,SAS,L ,107,116,240,39,87,0.448,27,62,0.435,12,25,0.48,17,21,0.81,44,78,0.564,34,54,0.63,10,24,0.417,18,19,0.947
11/18/2016,14,NOP,POR,W ,113,101,240,45,82,0.549,36,58,0.621,9,24,0.375,14,20,0.7,33,88,0.375,21,54,0.389,12,34,0.353,23,26,0.885
11/18/2016,10,OKC,BRK,W ,124,105,240,49,89,0.551,42,63,0.667,7,26,0.269,19,24,0.792,35,83,0.422,24,54,0.444,11,29,0.379,24,30,0.8
11/18/2016,1,SAC,LAC,L ,115,121,240,38,86,0.442,28,60,0.467,10,26,0.385,29,35,0.829,40,76,0.526,27,47,0.574,13,29,0.448,28,34,0.824
11/17/2016,3,HOU,POR,W ,126,109,240,46,95,0.484,32,63,0.508,14,32,0.438,20,25,0.8,41,90,0.456,31,62,0.5,10,28,0.357,17,21,0.81
11/17/2016,11,MIA,MIL,W ,96,73,240,39,97,0.402,32,67,0.478,7,30,0.233,11,21,0.524,28,85,0.329,21,62,0.339,7,23,0.304,10,13,0.769
11/17/2016,2,MIN,PHI,W ,110,86,240,43,84,0.512,37,59,0.627,6,25,0.24,18,20,0.9,31,83,0.373,22,51,0.431,9,32,0.281,15,19,0.789
11/17/2016,16,UTA,CHI,L ,77,85,240,30,78,0.385,25,53,0.472,5,25,0.2,12,14,0.857,33,90,0.367,28,73,0.384,5,17,0.294,14,16,0.875
11/17/2016,1,WAS,NYK,W ,119,112,240,44,81,0.543,29,56,0.518,15,25,0.6,16,18,0.889,41,86,0.477,29,57,0.509,12,29,0.414,18,20,0.9
11/16/2016,2,ATL,MIL,W ,107,100,240,35,72,0.486,25,40,0.625,10,32,0.313,27,31,0.871,39,98,0.398,31,66,0.47,8,32,0.25,14,18,0.778
11/16/2016,6,BOS,DAL,W ,90,83,240,33,76,0.434,26,55,0.473,7,21,0.333,17,23,0.739,34,83,0.41,26,60,0.433,8,23,0.348,7,10,0.7
11/16/2016,0,DEN,PHO,W ,120,104,240,45,93,0.484,37,76,0.487,8,17,0.471,22,24,0.917,39,79,0.494,31,59,0.525,8,20,0.4,18,29,0.621
11/16/2016,2,IND,CLE,W ,103,93,240,43,86,0.5,33,58,0.569,10,28,0.357,7,11,0.636,35,86,0.407,24,56,0.429,11,30,0.367,12,20,0.6
11/16/2016,10,LAC,MEM,L ,107,111,240,37,81,0.457,28,56,0.5,9,25,0.36,24,34,0.706,40,82,0.488,25,56,0.446,15,26,0.577,16,19,0.842
11/16/2016,6,NYK,DET,W ,105,102,240,42,93,0.452,33,68,0.485,9,25,0.36,12,19,0.632,42,85,0.494,34,62,0.548,8,23,0.348,10,12,0.833
11/16/2016,4,OKC,HOU,W ,105,103,240,40,84,0.476,28,59,0.475,12,25,0.48,13,14,0.929,40,92,0.435,26,52,0.5,14,40,0.35,9,14,0.643
11/16/2016,10,ORL,NOP,W ,89,82,240,34,88,0.386,24,61,0.393,10,27,0.37,11,19,0.579,30,82,0.366,23,61,0.377,7,21,0.333,15,19,0.789
11/16/2016,1,PHI,WAS,W ,109,102,240,42,77,0.545,32,49,0.653,10,28,0.357,15,22,0.682,38,91,0.418,30,68,0.441,8,23,0.348,18,25,0.72
11/16/2016,4,SAC,SAS,L ,105,110,240,36,76,0.474,27,56,0.482,9,20,0.45,24,31,0.774,43,88,0.489,32,58,0.552,11,30,0.367,13,17,0.765
11/16/2016,3,TOR,GSW,L ,121,127,240,37,82,0.451,27,57,0.474,10,25,0.4,37,41,0.902,44,87,0.506,31,51,0.608,13,36,0.361,26,28,0.929
11/15/2016,9,CLE,TOR,W ,121,117,240,44,83,0.53,31,50,0.62,13,33,0.394,20,28,0.714,46,96,0.479,33,67,0.493,13,29,0.448,12,18,0.667
11/15/2016,10,LAL,BRK,W ,125,118,240,41,92,0.446,32,64,0.5,9,28,0.321,34,43,0.791,45,99,0.455,33,58,0.569,12,41,0.293,16,20,0.8
11/15/2016,9,MIA,ATL,L ,90,93,240,36,89,0.404,29,66,0.439,7,23,0.304,11,14,0.786,37,80,0.463,31,63,0.492,6,17,0.353,13,19,0.684
11/15/2016,16,MIN,CHO,L ,108,115,240,38,89,0.427,23,54,0.426,15,35,0.429,17,21,0.81,43,80,0.538,32,56,0.571,11,24,0.458,18,22,0.818
11/15/2016,0,POR,CHI,L ,88,113,240,34,95,0.358,25,61,0.41,9,34,0.265,11,18,0.611,41,98,0.418,34,78,0.436,7,20,0.35,24,28,0.857
11/14/2016,4,DET,OKC,W ,104,88,240,43,92,0.467,38,76,0.5,5,16,0.313,13,16,0.813,33,88,0.375,28,61,0.459,5,27,0.185,17,22,0.773
11/14/2016,3,HOU,PHI,W ,115,88,240,44,91,0.484,27,51,0.529,17,40,0.425,10,17,0.588,34,90,0.378,29,68,0.426,5,22,0.227,15,17,0.882
11/14/2016,6,IND,ORL,W ,88,69,240,35,90,0.389,27,65,0.415,8,25,0.32,10,10,1,27,84,0.321,22,59,0.373,5,25,0.2,10,13,0.769
11/14/2016,1,LAC,BRK,W ,127,95,240,48,90,0.533,34,65,0.523,14,25,0.56,17,21,0.81,34,77,0.442,24,44,0.545,10,33,0.303,17,22,0.773
11/14/2016,6,NOP,BOS,W ,106,105,240,35,79,0.443,29,58,0.5,6,21,0.286,30,36,0.833,38,95,0.4,26,54,0.481,12,41,0.293,17,20,0.85
11/14/2016,8,NYK,DAL,W ,93,77,240,34,78,0.436,25,53,0.472,9,25,0.36,16,18,0.889,32,84,0.381,27,57,0.474,5,27,0.185,8,11,0.727
11/14/2016,1,SAS,MIA,W ,94,90,240,33,82,0.402,25,67,0.373,8,15,0.533,20,27,0.741,37,84,0.44,33,69,0.478,4,15,0.267,12,21,0.571
11/14/2016,6,UTA,MEM,L ,96,102,240,35,73,0.479,27,45,0.6,8,28,0.286,18,22,0.818,36,76,0.474,28,55,0.509,8,21,0.381,22,26,0.846
11/13/2016,12,CLE,CHO,W ,100,93,240,39,92,0.424,25,54,0.463,14,38,0.368,8,15,0.533,36,95,0.379,25,66,0.379,11,29,0.379,10,12,0.833
11/13/2016,14,GSW,PHO,W ,133,120,240,45,87,0.517,29,54,0.537,16,33,0.485,27,31,0.871,46,90,0.511,38,66,0.576,8,24,0.333,20,26,0.769
11/13/2016,6,MIN,LAL,W ,125,99,240,42,80,0.525,29,53,0.547,13,27,0.481,28,42,0.667,33,71,0.465,25,47,0.532,8,24,0.333,25,30,0.833
11/13/2016,10,OKC,ORL,L ,117,119,240,47,92,0.511,40,67,0.597,7,25,0.28,16,26,0.615,46,86,0.535,35,62,0.565,11,24,0.458,16,20,0.8
11/13/2016,5,POR,DEN,W ,112,105,240,39,99,0.394,31,70,0.443,8,29,0.276,26,32,0.813,36,91,0.396,25,62,0.403,11,29,0.379,22,29,0.759
11/12/2016,2,ATL,PHI,W ,117,96,240,48,95,0.505,35,63,0.556,13,32,0.406,8,14,0.571,36,83,0.434,25,54,0.463,11,29,0.379,13,20,0.65
11/12/2016,15,CHI,WAS,W ,106,95,240,39,97,0.402,34,82,0.415,5,15,0.333,23,25,0.92,38,91,0.418,34,78,0.436,4,13,0.308,15,18,0.833
11/12/2016,0,DEN,DET,L ,95,106,240,36,84,0.429,27,59,0.458,9,25,0.36,14,19,0.737,46,90,0.511,42,72,0.583,4,18,0.222,10,14,0.714
11/12/2016,2,HOU,SAS,L ,100,106,240,34,89,0.382,19,42,0.452,15,47,0.319,17,21,0.81,41,76,0.539,36,58,0.621,5,18,0.278,19,24,0.792
11/12/2016,10,IND,BOS,L ,99,105,240,36,86,0.419,30,59,0.508,6,27,0.222,21,28,0.75,35,80,0.438,27,55,0.491,8,25,0.32,27,33,0.818
11/12/2016,3,MIA,UTA,L ,91,102,240,38,81,0.469,33,64,0.516,5,17,0.294,10,19,0.526,40,81,0.494,34,61,0.557,6,20,0.3,16,19,0.842
11/12/2016,6,MIL,MEM,W ,106,96,240,36,68,0.529,29,50,0.58,7,18,0.389,27,36,0.75,35,78,0.449,29,48,0.604,6,30,0.2,20,21,0.952
11/12/2016,4,MIN,LAC,L ,105,119,240,40,89,0.449,32,67,0.478,8,22,0.364,17,21,0.81,40,76,0.526,29,52,0.558,11,24,0.458,28,37,0.757
11/12/2016,9,NOP,LAL,L ,99,126,240,39,90,0.433,33,70,0.471,6,20,0.3,15,19,0.789,52,94,0.553,36,64,0.563,16,30,0.533,6,7,0.857
11/12/2016,5,PHO,BRK,L ,104,122,240,40,107,0.374,32,74,0.432,8,33,0.242,16,21,0.762,40,84,0.476,24,47,0.511,16,37,0.432,26,30,0.867
11/12/2016,27,TOR,NYK,W ,118,107,240,39,83,0.47,32,61,0.525,7,22,0.318,33,38,0.868,44,97,0.454,37,74,0.5,7,23,0.304,12,16,0.75
11/11/2016,0,BOS,NYK,W ,115,87,240,35,90,0.389,24,63,0.381,11,27,0.407,34,43,0.791,33,94,0.351,27,71,0.38,6,23,0.261,15,17,0.882
11/11/2016,4,CHO,TOR,L ,111,113,240,38,93,0.409,21,52,0.404,17,41,0.415,18,24,0.75,43,90,0.478,37,68,0.544,6,22,0.273,21,22,0.955
11/11/2016,3,OKC,LAC,L ,108,110,240,38,88,0.432,22,60,0.367,16,28,0.571,16,19,0.842,39,86,0.453,28,59,0.475,11,27,0.407,21,35,0.6
11/11/2016,10,ORL,UTA,L ,74,87,240,26,78,0.333,18,58,0.31,8,20,0.4,14,19,0.737,33,81,0.407,26,53,0.491,7,28,0.25,14,16,0.875
11/11/2016,16,PHI,IND,W ,109,105,265,36,86,0.419,25,54,0.463,11,32,0.344,26,31,0.839,39,88,0.443,34,69,0.493,5,19,0.263,22,23,0.957
11/11/2016,14,POR,SAC,W ,122,120,265,45,86,0.523,32,53,0.604,13,33,0.394,19,27,0.704,43,88,0.489,37,67,0.552,6,21,0.286,28,35,0.8
11/11/2016,10,SAS,DET,W ,96,86,240,36,81,0.444,27,61,0.443,9,20,0.45,15,19,0.789,32,76,0.421,27,51,0.529,5,25,0.2,17,21,0.81
11/11/2016,5,WAS,CLE,L ,94,105,240,38,87,0.437,35,72,0.486,3,15,0.2,15,19,0.789,36,86,0.419,22,53,0.415,14,33,0.424,19,26,0.731
11/10/2016,2,DEN,GSW,L ,101,125,240,38,94,0.404,25,58,0.431,13,36,0.361,12,17,0.706,46,85,0.541,32,55,0.582,14,30,0.467,19,20,0.95
11/10/2016,19,MIA,CHI,L ,95,98,240,36,88,0.409,23,59,0.39,13,29,0.448,10,15,0.667,37,89,0.416,31,73,0.425,6,16,0.375,18,20,0.9
11/10/2016,5,MIL,NOP,L ,106,112,240,40,91,0.44,34,73,0.466,6,18,0.333,20,25,0.8,39,89,0.438,30,64,0.469,9,25,0.36,25,27,0.926
11/10/2016,4,SAC,LAL,L ,91,101,240,34,85,0.4,26,64,0.406,8,21,0.381,15,20,0.75,38,74,0.514,29,47,0.617,9,27,0.333,16,22,0.727
11/9/2016,9,ATL,CHI,W ,115,107,240,42,83,0.506,33,63,0.524,9,20,0.45,22,27,0.815,41,91,0.451,32,64,0.5,9,27,0.333,16,21,0.762
11/9/2016,10,CHO,UTA,W ,104,98,240,38,82,0.463,30,56,0.536,8,26,0.308,20,29,0.69,38,82,0.463,30,48,0.625,8,34,0.235,14,18,0.778
11/9/2016,0,GSW,DAL,W ,116,95,240,43,74,0.581,26,41,0.634,17,33,0.515,13,22,0.591,34,86,0.395,28,58,0.483,6,28,0.214,21,28,0.75
11/9/2016,15,IND,PHI,W ,122,115,265,49,90,0.544,40,71,0.563,9,19,0.474,15,20,0.75,46,95,0.484,32,59,0.542,14,36,0.389,9,19,0.474
11/9/2016,0,LAC,POR,W ,111,80,240,38,87,0.437,27,55,0.491,11,32,0.344,24,33,0.727,31,88,0.352,25,58,0.431,6,30,0.2,12,14,0.857
11/9/2016,4,NYK,BRK,W ,110,96,240,44,92,0.478,34,62,0.548,10,30,0.333,12,17,0.706,33,79,0.418,22,46,0.478,11,33,0.333,19,27,0.704
11/9/2016,3,OKC,TOR,L ,102,112,240,31,74,0.419,19,40,0.475,12,34,0.353,28,31,0.903,43,83,0.518,32,57,0.561,11,26,0.423,15,22,0.682
11/9/2016,0,ORL,MIN,L ,107,123,240,38,85,0.447,30,61,0.492,8,24,0.333,23,30,0.767,45,87,0.517,32,64,0.5,13,23,0.565,20,26,0.769
11/9/2016,16,PHO,DET,W ,107,100,240,38,84,0.452,30,62,0.484,8,22,0.364,23,30,0.767,32,89,0.36,23,67,0.343,9,22,0.409,27,32,0.844
11/9/2016,14,SAS,HOU,L ,99,101,240,33,84,0.393,26,61,0.426,7,23,0.304,26,30,0.867,37,78,0.474,27,48,0.563,10,30,0.333,17,22,0.773
11/9/2016,0,WAS,BOS,W ,118,93,240,46,92,0.5,36,71,0.507,10,21,0.476,16,20,0.8,35,81,0.432,25,50,0.5,10,31,0.323,13,22,0.591
11/8/2016,6,BRK,MIN,W ,119,110,240,42,76,0.553,30,43,0.698,12,33,0.364,23,26,0.885,39,92,0.424,27,64,0.422,12,28,0.429,20,28,0.714
11/8/2016,12,CLE,ATL,L ,106,110,240,37,99,0.374,26,57,0.456,11,42,0.262,21,25,0.84,41,81,0.506,30,52,0.577,11,29,0.379,17,24,0.708
11/8/2016,5,LAL,DAL,L ,97,109,240,38,78,0.487,28,52,0.538,10,26,0.385,11,14,0.786,43,82,0.524,33,59,0.559,10,23,0.435,13,15,0.867
11/8/2016,17,MEM,DEN,W ,108,107,240,44,86,0.512,37,62,0.597,7,24,0.292,13,19,0.684,35,70,0.5,25,46,0.543,10,24,0.417,27,34,0.794
11/8/2016,0,POR,PHO,W ,124,121,240,45,81,0.556,31,50,0.62,14,31,0.452,20,28,0.714,43,86,0.5,36,65,0.554,7,21,0.333,28,33,0.848
11/8/2016,0,SAC,NOP,W ,102,94,240,39,81,0.481,31,56,0.554,8,25,0.32,16,20,0.8,38,84,0.452,33,63,0.524,5,21,0.238,13,18,0.722
11/7/2016,3,CHI,ORL,W ,112,80,240,42,89,0.472,39,70,0.557,3,19,0.158,25,31,0.806,33,85,0.388,24,55,0.436,9,30,0.3,5,6,0.833
11/7/2016,1,CHO,IND,W ,122,100,240,41,84,0.488,29,52,0.558,12,32,0.375,28,32,0.875,40,94,0.426,31,61,0.508,9,33,0.273,11,15,0.733
11/7/2016,9,GSW,NOP,W ,116,106,240,45,90,0.5,29,55,0.527,16,35,0.457,10,12,0.833,39,80,0.488,32,59,0.542,7,21,0.333,21,27,0.778
11/7/2016,2,LAC,DET,W ,114,82,240,41,76,0.539,28,51,0.549,13,25,0.52,19,22,0.864,30,82,0.366,26,70,0.371,4,12,0.333,18,26,0.692
11/7/2016,1,OKC,MIA,W ,97,85,240,37,85,0.435,28,57,0.491,9,28,0.321,14,17,0.824,31,84,0.369,27,67,0.403,4,17,0.235,19,22,0.864
11/7/2016,8,PHI,UTA,L ,84,109,240,31,77,0.403,24,56,0.429,7,21,0.333,15,22,0.682,43,85,0.506,32,66,0.485,11,19,0.579,12,20,0.6
11/7/2016,25,WAS,HOU,L ,106,114,240,39,94,0.415,29,67,0.433,10,27,0.37,18,20,0.9,41,79,0.519,24,42,0.571,17,37,0.459,15,18,0.833
11/6/2016,1,BOS,DEN,L ,107,123,240,41,90,0.456,33,65,0.508,8,25,0.32,17,21,0.81,44,84,0.524,33,61,0.541,11,23,0.478,24,31,0.774
11/6/2016,5,DAL,MIL,W ,86,75,265,33,88,0.375,24,50,0.48,9,38,0.237,11,12,0.917,30,82,0.366,24,53,0.453,6,29,0.207,9,12,0.75
11/6/2016,4,LAL,PHO,W ,119,108,240,41,90,0.456,31,67,0.463,10,23,0.435,27,35,0.771,40,91,0.44,34,71,0.479,6,20,0.3,22,28,0.786
11/6/2016,13,MEM,POR,L ,94,100,240,31,81,0.383,25,55,0.455,6,26,0.231,26,32,0.813,32,71,0.451,18,38,0.474,14,33,0.424,22,27,0.815
11/6/2016,6,NYK,UTA,L ,109,114,240,42,83,0.506,34,63,0.54,8,20,0.4,17,19,0.895,38,75,0.507,30,50,0.6,8,25,0.32,30,35,0.857
11/6/2016,8,TOR,SAC,L ,91,96,240,30,84,0.357,23,54,0.426,7,30,0.233,24,31,0.774,34,78,0.436,29,62,0.468,5,16,0.313,23,31,0.742
11/5/2016,7,ATL,HOU,W ,112,97,240,45,85,0.529,37,65,0.569,8,20,0.4,14,24,0.583,37,85,0.435,25,49,0.51,12,36,0.333,11,13,0.846
11/5/2016,0,DET,DEN,W ,103,86,240,40,84,0.476,33,64,0.516,7,20,0.35,16,22,0.727,31,94,0.33,24,69,0.348,7,25,0.28,17,20,0.85
11/5/2016,0,IND,CHI,W ,111,94,240,46,86,0.535,34,60,0.567,12,26,0.462,7,12,0.583,34,79,0.43,28,61,0.459,6,18,0.333,20,25,0.8
11/5/2016,0,MIL,SAC,W ,117,91,240,41,82,0.5,27,49,0.551,14,33,0.424,21,25,0.84,33,84,0.393,23,56,0.411,10,28,0.357,15,19,0.789
11/5/2016,2,OKC,MIN,W ,112,92,240,45,86,0.523,38,70,0.543,7,16,0.438,15,24,0.625,33,84,0.393,29,65,0.446,4,19,0.211,22,29,0.759
11/5/2016,6,ORL,WAS,W ,88,86,240,31,78,0.397,22,50,0.44,9,28,0.321,17,27,0.63,34,86,0.395,28,69,0.406,6,17,0.353,12,17,0.706
11/5/2016,12,PHI,CLE,L ,101,102,240,40,87,0.46,26,49,0.531,14,38,0.368,7,12,0.583,37,91,0.407,23,53,0.434,14,38,0.368,14,18,0.778
11/5/2016,1,SAS,LAC,L ,92,116,240,30,74,0.405,20,49,0.408,10,25,0.4,22,25,0.88,47,91,0.516,38,68,0.559,9,23,0.391,13,14,0.929
11/4/2016,1,BRK,CHO,L ,95,99,240,35,87,0.402,26,51,0.51,9,36,0.25,16,21,0.762,36,86,0.419,26,56,0.464,10,30,0.333,17,24,0.708
11/4/2016,10,CHI,NYK,L ,104,117,240,37,84,0.44,29,61,0.475,8,23,0.348,22,27,0.815,46,89,0.517,37,68,0.544,9,21,0.429,16,21,0.762
11/4/2016,2,DAL,POR,L ,95,105,240,34,83,0.41,24,55,0.436,10,28,0.357,17,20,0.85,36,80,0.45,24,49,0.49,12,31,0.387,21,26,0.808
11/4/2016,0,LAL,GSW,W ,117,97,240,45,95,0.474,37,65,0.569,8,30,0.267,19,21,0.905,39,86,0.453,34,54,0.63,5,32,0.156,14,20,0.7
11/4/2016,1,MEM,LAC,L ,88,99,240,31,84,0.369,22,58,0.379,9,26,0.346,17,22,0.773,32,85,0.376,24,58,0.414,8,27,0.296,27,33,0.818
11/4/2016,10,NOP,PHO,L ,111,112,265,43,94,0.457,33,64,0.516,10,30,0.333,15,28,0.536,40,93,0.43,32,69,0.464,8,24,0.333,24,28,0.857
11/4/2016,1,TOR,MIA,W ,96,87,240,37,84,0.44,31,59,0.525,6,25,0.24,16,18,0.889,34,88,0.386,25,60,0.417,9,28,0.321,10,15,0.667
11/4/2016,2,UTA,SAS,L ,86,100,240,30,80,0.375,19,54,0.352,11,26,0.423,15,24,0.625,37,83,0.446,31,63,0.492,6,20,0.3,20,22,0.909
11/4/2016,4,WAS,ATL,W ,95,92,240,31,80,0.388,26,60,0.433,5,20,0.25,28,35,0.8,32,83,0.386,27,58,0.466,5,25,0.2,23,36,0.639
11/3/2016,4,CLE,BOS,W ,128,122,240,41,84,0.488,27,50,0.54,14,34,0.412,32,37,0.865,46,96,0.479,35,64,0.547,11,32,0.344,19,22,0.864
11/3/2016,3,GSW,OKC,W ,122,96,240,46,89,0.517,32,59,0.542,14,30,0.467,16,20,0.8,35,87,0.402,25,60,0.417,10,27,0.37,16,28,0.571
11/3/2016,11,MIL,IND,W ,125,107,240,47,82,0.573,35,55,0.636,12,27,0.444,19,24,0.792,38,81,0.469,28,58,0.483,10,23,0.435,21,27,0.778
11/3/2016,4,MIN,DEN,L ,99,102,240,35,88,0.398,26,66,0.394,9,22,0.409,20,25,0.8,39,81,0.481,33,59,0.559,6,22,0.273,18,25,0.72
11/3/2016,6,ORL,SAC,W ,102,94,240,38,84,0.452,28,54,0.519,10,30,0.333,16,23,0.696,38,80,0.475,31,62,0.5,7,18,0.389,11,17,0.647
11/2/2016,7,ATL,LAL,L ,116,123,240,41,85,0.482,30,53,0.566,11,32,0.344,23,29,0.793,48,90,0.533,39,68,0.574,9,22,0.409,18,20,0.9
11/2/2016,1,BOS,CHI,W ,107,100,240,41,87,0.471,27,55,0.491,14,32,0.438,11,17,0.647,35,81,0.432,28,61,0.459,7,20,0.35,23,31,0.742
11/2/2016,3,BRK,DET,W ,109,101,240,41,76,0.539,28,49,0.571,13,27,0.481,14,17,0.824,37,88,0.42,28,63,0.444,9,25,0.36,18,21,0.857
11/2/2016,6,CHO,PHI,W ,109,93,240,39,79,0.494,26,45,0.578,13,34,0.382,18,26,0.692,34,86,0.395,22,48,0.458,12,38,0.316,13,15,0.867
11/2/2016,20,LAC,OKC,L ,83,85,240,34,87,0.391,27,65,0.415,7,22,0.318,8,18,0.444,34,84,0.405,29,64,0.453,5,20,0.25,12,20,0.6
11/2/2016,9,MEM,NOP,W ,89,83,265,33,94,0.351,25,67,0.373,8,27,0.296,15,20,0.75,30,81,0.37,19,47,0.404,11,34,0.324,12,16,0.75
11/2/2016,3,NYK,HOU,L ,99,118,240,37,85,0.435,29,65,0.446,8,20,0.4,17,25,0.68,42,89,0.472,27,49,0.551,15,40,0.375,19,27,0.704
11/2/2016,12,PHO,POR,W ,118,115,265,44,103,0.427,39,87,0.448,5,16,0.313,25,30,0.833,42,101,0.416,30,68,0.441,12,33,0.364,19,21,0.905
11/2/2016,2,UTA,DAL,W ,97,81,240,35,77,0.455,23,52,0.442,12,25,0.48,15,26,0.577,33,77,0.429,26,51,0.51,7,26,0.269,8,10,0.8
11/2/2016,7,WAS,TOR,L ,103,113,240,42,72,0.583,39,62,0.629,3,10,0.3,16,24,0.667,43,77,0.558,33,52,0.635,10,25,0.4,17,25,0.68
11/1/2016,4,CLE,HOU,W ,128,120,240,43,83,0.518,27,51,0.529,16,32,0.5,26,31,0.839,43,90,0.478,26,46,0.565,17,44,0.386,17,25,0.68
11/1/2016,5,DET,NYK,W ,102,89,240,41,89,0.461,33,76,0.434,8,13,0.615,12,21,0.571,35,86,0.407,28,64,0.438,7,22,0.318,12,15,0.8
11/1/2016,5,IND,LAL,W ,115,108,240,41,87,0.471,31,59,0.525,10,28,0.357,23,29,0.793,40,89,0.449,34,61,0.557,6,28,0.214,22,25,0.88
11/1/2016,12,MIA,SAC,W ,108,96,265,37,86,0.43,24,57,0.421,13,29,0.448,21,29,0.724,34,89,0.382,29,66,0.439,5,23,0.217,23,27,0.852
11/1/2016,7,MIN,MEM,W ,116,80,240,43,78,0.551,31,58,0.534,12,20,0.6,18,23,0.783,27,75,0.36,23,51,0.451,4,24,0.167,22,29,0.759
11/1/2016,5,NOP,MIL,L ,113,117,240,36,82,0.439,27,56,0.482,9,26,0.346,32,41,0.78,44,91,0.484,34,59,0.576,10,32,0.313,19,21,0.905
11/1/2016,3,PHI,ORL,L ,101,103,240,40,81,0.494,31,61,0.508,9,20,0.45,12,16,0.75,42,93,0.452,36,68,0.529,6,25,0.24,13,17,0.765
11/1/2016,4,POR,GSW,L ,104,127,240,37,86,0.43,23,47,0.489,14,39,0.359,16,21,0.762,50,89,0.562,40,63,0.635,10,26,0.385,17,23,0.739
11/1/2016,5,SAS,UTA,L ,91,106,240,33,76,0.434,27,56,0.482,6,20,0.3,19,21,0.905,38,76,0.5,23,45,0.511,15,31,0.484,15,18,0.833
10/31/2016,4,ATL,SAC,W ,106,95,240,33,79,0.418,22,49,0.449,11,30,0.367,29,47,0.617,36,75,0.48,26,52,0.5,10,23,0.435,13,19,0.684
10/31/2016,0,BRK,CHI,L ,88,118,240,33,96,0.344,28,65,0.431,5,31,0.161,17,21,0.81,45,89,0.506,34,62,0.548,11,27,0.407,17,18,0.944
10/31/2016,11,LAC,PHO,W ,116,98,240,40,80,0.5,34,64,0.531,6,16,0.375,30,38,0.789,35,84,0.417,30,69,0.435,5,15,0.333,23,31,0.742
10/31/2016,8,TOR,DEN,W ,105,102,240,41,88,0.466,37,72,0.514,4,16,0.25,19,25,0.76,33,81,0.407,24,59,0.407,9,22,0.409,27,35,0.771
10/30/2016,1,DET,MIL,W ,98,83,240,39,88,0.443,34,68,0.5,5,20,0.25,15,20,0.75,34,87,0.391,30,70,0.429,4,17,0.235,11,14,0.786
10/30/2016,3,HOU,DAL,W ,93,92,240,34,81,0.42,23,50,0.46,11,31,0.355,14,21,0.667,32,86,0.372,21,55,0.382,11,31,0.355,17,20,0.85
10/30/2016,2,LAC,UTA,W ,88,75,240,34,83,0.41,28,56,0.5,6,27,0.222,14,20,0.7,29,73,0.397,22,54,0.407,7,19,0.368,10,13,0.769
10/30/2016,16,MEM,WAS,W ,112,103,265,39,88,0.443,24,57,0.421,15,31,0.484,19,26,0.731,38,86,0.442,33,61,0.541,5,25,0.2,22,25,0.88
10/30/2016,3,MIA,SAS,L ,99,106,240,37,80,0.463,30,60,0.5,7,20,0.35,18,26,0.692,37,82,0.451,27,64,0.422,10,18,0.556,22,26,0.846
10/30/2016,6,OKC,LAL,W ,113,96,240,45,95,0.474,36,69,0.522,9,26,0.346,14,17,0.824,35,87,0.402,28,55,0.509,7,32,0.219,19,24,0.792
10/30/2016,12,PHO,GSW,L ,100,106,240,37,90,0.411,29,67,0.433,8,23,0.348,18,25,0.72,35,83,0.422,27,54,0.5,8,29,0.276,28,33,0.848
10/29/2016,4,CHI,IND,W ,118,101,240,45,86,0.523,36,65,0.554,9,21,0.429,19,21,0.905,43,88,0.489,36,70,0.514,7,18,0.389,8,9,0.889
10/29/2016,3,CHO,BOS,L ,98,104,240,32,79,0.405,23,47,0.489,9,32,0.281,25,33,0.758,39,81,0.481,24,50,0.48,15,31,0.484,11,17,0.647
10/29/2016,1,CLE,ORL,W ,105,99,240,36,88,0.409,25,51,0.49,11,37,0.297,22,30,0.733,38,84,0.452,30,56,0.536,8,28,0.286,15,26,0.577
10/29/2016,4,DEN,POR,L ,113,115,265,38,100,0.38,32,77,0.416,6,23,0.261,31,39,0.795,45,98,0.459,35,66,0.53,10,32,0.313,15,21,0.714
10/29/2016,8,MIL,BRK,W ,110,108,240,41,88,0.466,33,66,0.5,8,22,0.364,20,24,0.833,37,84,0.44,26,50,0.52,11,34,0.324,23,28,0.821
10/29/2016,0,NYK,MEM,W ,111,104,240,40,76,0.526,34,55,0.618,6,21,0.286,25,39,0.641,37,86,0.43,28,61,0.459,9,25,0.36,21,26,0.808
10/29/2016,5,PHI,ATL,L ,72,104,240,28,80,0.35,23,62,0.371,5,18,0.278,11,15,0.733,42,85,0.494,37,65,0.569,5,20,0.25,15,23,0.652
10/29/2016,8,SAC,MIN,W ,106,103,240,39,85,0.459,30,59,0.508,9,26,0.346,19,25,0.76,37,70,0.529,30,48,0.625,7,22,0.318,22,31,0.71
10/29/2016,3,SAS,NOP,W ,98,79,240,35,83,0.422,25,59,0.424,10,24,0.417,18,23,0.783,32,86,0.372,28,64,0.438,4,22,0.182,11,15,0.733
10/28/2016,8,BRK,IND,W ,103,94,240,38,87,0.437,28,54,0.519,10,33,0.303,17,20,0.85,37,98,0.378,30,74,0.405,7,24,0.292,13,20,0.65
10/28/2016,19,DAL,HOU,L ,98,106,240,35,80,0.438,27,51,0.529,8,29,0.276,20,24,0.833,33,70,0.471,18,38,0.474,15,32,0.469,25,31,0.806
10/28/2016,2,DET,ORL,W ,108,82,240,48,95,0.505,41,76,0.539,7,19,0.368,5,6,0.833,33,95,0.347,25,69,0.362,8,26,0.308,8,12,0.667
10/28/2016,1,MIA,CHO,L ,91,97,240,32,86,0.372,18,52,0.346,14,34,0.412,13,20,0.65,35,92,0.38,28,70,0.4,7,22,0.318,20,24,0.833
10/28/2016,3,NOP,GSW,L ,114,122,240,47,100,0.47,42,78,0.538,5,22,0.227,15,23,0.652,44,91,0.484,35,63,0.556,9,28,0.321,25,28,0.893
10/28/2016,7,OKC,PHO,W ,113,110,265,40,96,0.417,35,75,0.467,5,21,0.238,28,38,0.737,42,94,0.447,37,66,0.561,5,28,0.179,21,32,0.656
10/28/2016,2,TOR,CLE,L ,91,94,240,35,90,0.389,31,74,0.419,4,16,0.25,17,18,0.944,33,79,0.418,21,47,0.447,12,32,0.375,16,22,0.727
10/28/2016,20,UTA,LAL,W ,96,89,240,31,75,0.413,25,50,0.5,6,25,0.24,28,40,0.7,32,84,0.381,23,61,0.377,9,23,0.391,16,21,0.762
10/27/2016,19,ATL,WAS,W ,114,99,240,44,88,0.5,32,62,0.516,12,26,0.462,14,18,0.778,40,94,0.426,34,74,0.459,6,20,0.3,13,18,0.722
10/27/2016,2,CHI,BOS,W ,105,99,240,36,92,0.391,25,67,0.373,11,25,0.44,22,30,0.733,38,76,0.5,30,53,0.566,8,23,0.348,15,24,0.625
10/27/2016,10,POR,LAC,L ,106,114,240,39,85,0.459,35,67,0.522,4,18,0.222,24,32,0.75,37,91,0.407,29,62,0.468,8,29,0.276,32,46,0.696
10/27/2016,3,SAC,SAS,L ,94,102,240,28,70,0.4,22,50,0.44,6,20,0.3,32,38,0.842,36,79,0.456,30,61,0.492,6,18,0.333,24,27,0.889
10/26/2016,2,BOS,BRK,W ,122,117,240,48,89,0.539,37,57,0.649,11,32,0.344,15,18,0.833,43,97,0.443,28,53,0.528,15,44,0.341,16,20,0.8
10/26/2016,6,IND,DAL,W ,130,121,265,47,93,0.505,37,74,0.5,10,19,0.526,26,34,0.765,45,104,0.433,27,56,0.482,18,48,0.375,13,18,0.722
10/26/2016,9,LAL,HOU,W ,120,114,240,45,89,0.506,33,54,0.611,12,35,0.343,18,22,0.818,44,86,0.512,37,57,0.649,7,29,0.241,19,27,0.704
10/26/2016,11,MEM,MIN,W ,102,98,240,36,80,0.45,25,56,0.446,11,24,0.458,19,27,0.704,36,86,0.419,30,68,0.441,6,18,0.333,20,29,0.69
10/26/2016,0,MIL,CHO,L ,96,107,240,39,92,0.424,36,76,0.474,3,16,0.188,15,20,0.75,40,89,0.449,33,66,0.5,7,23,0.304,20,24,0.833
10/26/2016,4,NOP,DEN,L ,102,107,240,38,92,0.413,35,73,0.479,3,19,0.158,23,26,0.885,37,83,0.446,29,59,0.492,8,24,0.333,25,33,0.758
10/26/2016,14,ORL,MIA,L ,96,108,240,34,89,0.382,28,71,0.394,6,18,0.333,22,28,0.786,47,97,0.485,43,81,0.531,4,16,0.25,10,16,0.625
10/26/2016,13,PHI,OKC,L ,97,103,240,36,84,0.429,29,60,0.483,7,24,0.292,18,25,0.72,39,94,0.415,33,72,0.458,6,22,0.273,19,26,0.731
10/26/2016,2,PHO,SAC,L ,94,113,240,36,77,0.468,32,61,0.525,4,16,0.25,18,27,0.667,44,86,0.512,38,65,0.585,6,21,0.286,19,26,0.731
10/26/2016,1,TOR,DET,W ,109,91,240,41,86,0.477,38,68,0.559,3,18,0.167,24,29,0.828,35,84,0.417,31,62,0.5,4,22,0.182,17,22,0.773
10/25/2016,1,CLE,NYK,W ,117,88,240,45,94,0.479,32,59,0.542,13,35,0.371,14,19,0.737,32,87,0.368,23,60,0.383,9,27,0.333,15,20,0.75
10/25/2016,2,GSW,SAS,L ,100,129,240,40,85,0.471,33,52,0.635,7,33,0.212,13,18,0.722,47,98,0.48,35,74,0.473,12,24,0.5,23,26,0.885
10/25/2016,11,POR,UTA,W ,113,104,240,39,75,0.52,26,56,0.464,13,19,0.684,22,22,1,40,82,0.488,32,58,0.552,8,24,0.333,16,16,1
4/15/2015,7,BRK,ORL,W ,101,88,240,39,80,0.488,30,56,0.536,9,24,0.375,14,23,0.609,38,79,0.481,31,59,0.525,7,20,0.35,5,13,0.385
4/15/2015,7,CHI,ATL,W ,91,85,240,31,77,0.403,24,53,0.453,7,24,0.292,22,26,0.846,36,92,0.391,28,63,0.444,8,29,0.276,5,7,0.714
4/15/2015,3,CLE,WAS,W ,113,108,265,43,91,0.473,27,61,0.443,16,30,0.533,11,17,0.647,42,97,0.433,34,75,0.453,8,22,0.364,16,21,0.762
4/15/2015,0,DAL,POR,W ,114,98,240,39,86,0.453,30,61,0.492,9,25,0.36,27,34,0.794,38,91,0.418,31,66,0.47,7,25,0.28,15,18,0.833
4/15/2015,4,GSW,DEN,W ,133,126,240,47,90,0.522,34,62,0.548,13,28,0.464,26,34,0.765,45,83,0.542,39,65,0.6,6,18,0.333,30,36,0.833
4/15/2015,0,HOU,UTA,W ,117,91,240,41,76,0.539,29,48,0.604,12,28,0.429,23,34,0.676,38,101,0.376,33,74,0.446,5,27,0.185,10,18,0.556
4/15/2015,5,LAL,SAC,L ,99,122,240,36,94,0.383,29,70,0.414,7,24,0.292,20,25,0.8,46,84,0.548,38,67,0.567,8,17,0.471,22,41,0.537
4/15/2015,1,MEM,IND,W ,95,83,240,36,76,0.474,34,67,0.507,2,9,0.222,21,26,0.808,32,78,0.41,24,54,0.444,8,24,0.333,11,15,0.733
4/15/2015,11,MIL,BOS,L ,100,105,240,41,89,0.461,34,68,0.5,7,21,0.333,11,16,0.688,42,85,0.494,29,55,0.527,13,30,0.433,8,14,0.571
4/15/2015,0,MIN,OKC,L ,113,138,240,39,84,0.464,33,65,0.508,6,19,0.316,29,35,0.829,52,95,0.547,40,67,0.597,12,28,0.429,22,31,0.71
4/15/2015,1,NOP,SAS,W ,108,103,240,43,83,0.518,38,73,0.521,5,10,0.5,17,25,0.68,45,79,0.57,42,69,0.609,3,10,0.3,10,13,0.769
4/15/2015,0,NYK,DET,L ,90,112,240,33,77,0.429,26,58,0.448,7,19,0.368,17,27,0.63,41,81,0.506,31,55,0.564,10,26,0.385,20,27,0.741
4/15/2015,8,PHI,MIA,L ,101,105,240,38,83,0.458,33,54,0.611,5,29,0.172,20,25,0.8,39,89,0.438,27,58,0.466,12,31,0.387,15,20,0.75
4/15/2015,3,TOR,CHO,W ,92,87,240,38,77,0.494,26,44,0.591,12,33,0.364,4,4,1,30,71,0.423,18,38,0.474,12,33,0.364,15,16,0.938
4/14/2015,11,BOS,TOR,W ,95,93,240,38,99,0.384,32,72,0.444,6,27,0.222,13,15,0.867,35,80,0.438,26,56,0.464,9,24,0.375,14,20,0.7
4/14/2015,9,IND,WAS,W ,99,95,290,40,105,0.381,31,75,0.413,9,30,0.3,10,17,0.588,37,104,0.356,30,80,0.375,7,24,0.292,14,17,0.824
4/14/2015,0,PHO,LAC,L ,101,112,240,39,80,0.488,28,54,0.519,11,26,0.423,12,20,0.6,42,87,0.483,27,49,0.551,15,38,0.395,13,18,0.722
4/13/2015,4,ATL,NYK,L ,108,112,240,39,88,0.443,28,56,0.5,11,32,0.344,19,23,0.826,43,77,0.558,30,52,0.577,13,25,0.52,13,19,0.684
4/13/2015,4,BRK,CHI,L ,86,113,240,32,87,0.368,29,75,0.387,3,12,0.25,19,22,0.864,44,88,0.5,32,58,0.552,12,30,0.4,13,17,0.765
4/13/2015,10,CHO,HOU,L ,90,100,240,34,83,0.41,21,51,0.412,13,32,0.406,9,17,0.529,35,85,0.412,26,50,0.52,9,35,0.257,21,26,0.808
4/13/2015,2,CLE,DET,W ,109,97,240,43,85,0.506,26,53,0.491,17,32,0.531,6,12,0.5,38,83,0.458,29,58,0.5,9,25,0.36,12,20,0.6
4/13/2015,0,GSW,MEM,W ,111,107,240,39,74,0.527,26,50,0.52,13,24,0.542,20,27,0.741,41,98,0.418,36,83,0.434,5,15,0.333,20,25,0.8
4/13/2015,16,LAC,DEN,W ,110,103,240,37,82,0.451,30,61,0.492,7,21,0.333,29,37,0.784,38,101,0.376,26,68,0.382,12,33,0.364,15,22,0.682
4/13/2015,2,MIA,ORL,W ,100,93,240,39,83,0.47,36,73,0.493,3,10,0.3,19,23,0.826,35,85,0.412,29,64,0.453,6,21,0.286,17,28,0.607
4/13/2015,2,MIN,NOP,L ,88,100,240,31,78,0.397,27,64,0.422,4,14,0.286,22,28,0.786,37,84,0.44,31,63,0.492,6,21,0.286,20,24,0.833
4/13/2015,0,OKC,POR,W ,101,90,240,39,96,0.406,35,75,0.467,4,21,0.19,19,27,0.704,38,83,0.458,30,60,0.5,8,23,0.348,6,9,0.667
4/13/2015,9,PHI,MIL,L ,97,107,240,32,81,0.395,26,53,0.491,6,28,0.214,27,34,0.794,40,81,0.494,36,72,0.5,4,9,0.444,23,36,0.639
4/13/2015,23,SAC,LAL,W ,102,92,240,35,72,0.486,31,56,0.554,4,16,0.25,28,36,0.778,40,96,0.417,36,81,0.444,4,15,0.267,8,13,0.615
4/13/2015,6,UTA,DAL,W ,109,92,240,41,82,0.5,30,54,0.556,11,28,0.393,16,26,0.615,34,82,0.415,25,62,0.403,9,20,0.45,15,23,0.652
4/12/2015,2,BOS,CLE,W ,117,78,240,46,84,0.548,36,60,0.6,10,24,0.417,15,22,0.682,31,79,0.392,28,57,0.491,3,22,0.136,13,19,0.684
4/12/2015,2,DEN,SAC,W ,122,111,240,45,82,0.549,36,56,0.643,9,26,0.346,23,30,0.767,38,74,0.514,33,56,0.589,5,18,0.278,30,42,0.714
4/12/2015,0,DET,CHO,W ,116,77,240,41,81,0.506,25,53,0.472,16,28,0.571,18,23,0.783,27,79,0.342,23,64,0.359,4,15,0.267,19,29,0.655
4/12/2015,3,HOU,NOP,W ,121,114,240,39,73,0.534,30,49,0.612,9,24,0.375,34,48,0.708,44,91,0.484,33,64,0.516,11,27,0.407,15,22,0.682
4/12/2015,12,IND,OKC,W ,116,104,240,42,79,0.532,32,59,0.542,10,20,0.5,22,35,0.629,41,95,0.432,30,67,0.448,11,28,0.393,11,28,0.393
4/12/2015,1,LAL,DAL,L ,106,120,240,34,78,0.436,25,54,0.463,9,24,0.375,29,36,0.806,45,83,0.542,35,62,0.565,10,21,0.476,20,26,0.769
4/12/2015,5,MIL,BRK,W ,96,73,240,41,83,0.494,35,63,0.556,6,20,0.3,8,12,0.667,27,83,0.325,24,65,0.369,3,18,0.167,16,22,0.727
4/12/2015,1,SAS,PHO,W ,107,91,240,35,69,0.507,27,50,0.54,8,19,0.421,29,34,0.853,35,85,0.412,31,69,0.449,4,16,0.25,17,23,0.739
4/12/2015,1,WAS,ATL,W ,108,99,240,39,85,0.459,30,64,0.469,9,21,0.429,21,27,0.778,36,87,0.414,27,58,0.466,9,29,0.31,18,24,0.75
4/11/2015,12,CHI,PHI,W ,114,107,240,40,90,0.444,31,64,0.484,9,26,0.346,25,36,0.694,37,89,0.416,24,48,0.5,13,41,0.317,20,25,0.8
4/11/2015,6,GSW,MIN,W ,110,101,240,42,93,0.452,31,62,0.5,11,31,0.355,15,21,0.714,35,79,0.443,24,55,0.436,11,24,0.458,20,26,0.769
4/11/2015,9,LAC,MEM,W ,94,86,240,35,88,0.398,29,61,0.475,6,27,0.222,18,22,0.818,34,77,0.442,32,68,0.471,2,9,0.222,16,24,0.667
4/11/2015,6,MIA,TOR,L ,104,107,240,37,81,0.457,31,61,0.508,6,20,0.3,24,44,0.545,35,83,0.422,26,57,0.456,9,26,0.346,28,37,0.757
4/11/2015,6,ORL,NYK,L ,79,80,240,30,84,0.357,24,62,0.387,6,22,0.273,13,18,0.722,31,82,0.378,25,62,0.403,6,20,0.3,12,13,0.923
4/11/2015,4,POR,UTA,L ,105,111,240,41,87,0.471,35,57,0.614,6,30,0.2,17,22,0.773,36,79,0.456,30,62,0.484,6,17,0.353,33,42,0.786
4/10/2015,2,ATL,CHO,W ,104,80,240,41,82,0.5,31,54,0.574,10,28,0.357,12,16,0.75,30,83,0.361,22,53,0.415,8,30,0.267,12,18,0.667
4/10/2015,1,BRK,WAS,W ,117,80,240,45,89,0.506,33,69,0.478,12,20,0.6,15,23,0.652,32,82,0.39,27,67,0.403,5,15,0.333,11,17,0.647
4/10/2015,2,CLE,BOS,L ,90,99,240,32,77,0.416,23,43,0.535,9,34,0.265,17,25,0.68,38,84,0.452,30,62,0.484,8,22,0.364,15,21,0.714
4/10/2015,6,DEN,DAL,L ,143,144,290,53,125,0.424,38,82,0.463,15,43,0.349,22,25,0.88,57,109,0.523,46,80,0.575,11,29,0.379,19,24,0.792
4/10/2015,14,DET,IND,L ,103,107,240,40,89,0.449,29,66,0.439,11,23,0.478,12,23,0.522,38,79,0.481,27,60,0.45,11,19,0.579,20,22,0.909
4/10/2015,1,HOU,SAS,L ,103,104,240,31,66,0.47,22,45,0.489,9,21,0.429,32,53,0.604,41,85,0.482,37,68,0.544,4,17,0.235,18,24,0.75
4/10/2015,2,LAL,MIN,W ,106,98,240,41,83,0.494,32,60,0.533,9,23,0.391,15,24,0.625,32,74,0.432,29,59,0.492,3,15,0.2,31,34,0.912
4/10/2015,6,NOP,PHO,W ,90,75,240,37,84,0.44,32,65,0.492,5,19,0.263,11,19,0.579,30,85,0.353,23,60,0.383,7,25,0.28,8,10,0.8
4/10/2015,12,NYK,MIL,L ,91,99,240,34,72,0.472,29,59,0.492,5,13,0.385,18,24,0.75,37,76,0.487,31,59,0.525,6,17,0.353,19,29,0.655
4/10/2015,6,OKC,SAC,W ,116,103,240,44,97,0.454,34,66,0.515,10,31,0.323,18,24,0.75,37,81,0.457,28,57,0.491,9,24,0.375,20,28,0.714
4/10/2015,14,ORL,TOR,L ,99,101,240,41,89,0.461,34,69,0.493,7,20,0.35,10,10,1,39,94,0.415,30,64,0.469,9,30,0.3,14,15,0.933
4/10/2015,14,UTA,MEM,L ,88,89,240,31,71,0.437,20,48,0.417,11,23,0.478,15,22,0.682,36,76,0.474,31,61,0.508,5,15,0.333,12,19,0.632
4/9/2015,8,GSW,POR,W ,116,105,240,48,90,0.533,36,64,0.563,12,26,0.462,8,9,0.889,46,98,0.469,39,74,0.527,7,24,0.292,6,8,0.75
4/9/2015,6,MIA,CHI,L ,78,89,240,34,88,0.386,29,70,0.414,5,18,0.278,5,7,0.714,35,91,0.385,29,68,0.426,6,23,0.261,13,17,0.765
4/8/2015,4,BRK,ATL,L ,111,114,240,41,87,0.471,34,61,0.557,7,26,0.269,22,25,0.88,43,86,0.5,32,58,0.552,11,28,0.393,17,25,0.68
4/8/2015,1,CHO,TOR,L ,74,92,240,28,81,0.346,18,59,0.305,10,22,0.455,8,11,0.727,33,77,0.429,21,50,0.42,12,27,0.444,14,19,0.737
4/8/2015,14,DAL,PHO,W ,107,104,240,45,94,0.479,41,76,0.539,4,18,0.222,13,16,0.813,40,82,0.488,32,57,0.561,8,25,0.32,16,19,0.842
4/8/2015,9,DEN,LAL,W ,119,101,240,44,88,0.5,31,58,0.534,13,30,0.433,18,24,0.75,36,75,0.48,31,59,0.525,5,16,0.313,24,35,0.686
4/8/2015,2,DET,BOS,L ,103,113,240,45,84,0.536,38,66,0.576,7,18,0.389,6,10,0.6,36,80,0.45,28,52,0.538,8,28,0.286,33,34,0.971
4/8/2015,3,MEM,NOP,W ,110,74,240,45,88,0.511,37,71,0.521,8,17,0.471,12,14,0.857,28,80,0.35,22,59,0.373,6,21,0.286,12,18,0.667
4/8/2015,9,MIL,CLE,L ,99,104,240,42,84,0.5,36,66,0.545,6,18,0.333,9,13,0.692,36,74,0.486,25,40,0.625,11,34,0.324,21,26,0.808
4/8/2015,0,NYK,IND,L ,86,102,240,29,84,0.345,22,67,0.328,7,17,0.412,21,26,0.808,38,77,0.494,34,55,0.618,4,22,0.182,22,27,0.815
4/8/2015,14,ORL,CHI,W ,105,103,240,38,82,0.463,30,59,0.508,8,23,0.348,21,24,0.875,34,79,0.43,22,53,0.415,12,26,0.462,23,31,0.742
4/8/2015,0,PHI,WAS,L ,90,119,240,31,89,0.348,22,62,0.355,9,27,0.333,19,27,0.704,47,72,0.653,39,57,0.684,8,15,0.533,17,23,0.739
4/8/2015,0,POR,MIN,W ,116,91,240,42,85,0.494,30,52,0.577,12,33,0.364,20,23,0.87,32,85,0.376,29,74,0.392,3,11,0.273,24,29,0.828
4/8/2015,2,SAS,HOU,W ,110,98,240,48,95,0.505,41,74,0.554,7,21,0.333,7,9,0.778,39,84,0.464,29,59,0.492,10,25,0.4,10,16,0.625
4/8/2015,12,UTA,SAC,W ,103,91,240,36,74,0.486,23,43,0.535,13,31,0.419,18,25,0.72,33,75,0.44,26,59,0.441,7,16,0.438,18,28,0.643
4/7/2015,1,ATL,PHO,W ,96,69,240,41,83,0.494,37,58,0.638,4,25,0.16,10,14,0.714,26,83,0.313,22,63,0.349,4,20,0.2,13,18,0.722
4/7/2015,6,LAC,LAL,W ,105,100,240,39,81,0.481,32,57,0.561,7,24,0.292,20,30,0.667,35,84,0.417,26,59,0.441,9,25,0.36,21,27,0.778
4/7/2015,11,MIA,CHO,W ,105,100,240,40,81,0.494,37,66,0.561,3,15,0.2,22,28,0.786,39,91,0.429,34,73,0.466,5,18,0.278,17,21,0.81
4/7/2015,16,NOP,GSW,W ,103,100,240,36,83,0.434,27,64,0.422,9,19,0.474,22,30,0.733,42,95,0.442,33,73,0.452,9,22,0.409,7,10,0.7
4/7/2015,0,OKC,SAS,L ,88,113,240,34,84,0.405,29,65,0.446,5,19,0.263,15,28,0.536,47,89,0.528,37,65,0.569,10,24,0.417,9,13,0.692
4/7/2015,6,SAC,MIN,W ,116,111,240,42,80,0.525,33,56,0.589,9,24,0.375,23,34,0.676,45,93,0.484,39,74,0.527,6,19,0.316,15,21,0.714
4/6/2015,4,BRK,POR,W ,106,96,240,41,91,0.451,35,77,0.455,6,14,0.429,18,23,0.783,39,87,0.448,28,61,0.459,11,26,0.423,7,9,0.778
4/5/2015,2,CLE,CHI,W ,99,94,240,35,83,0.422,19,46,0.413,16,37,0.432,13,22,0.591,34,76,0.447,23,49,0.469,11,27,0.407,15,21,0.714
4/5/2015,6,IND,MIA,W ,112,89,240,37,85,0.435,23,55,0.418,14,30,0.467,24,36,0.667,37,82,0.451,35,62,0.565,2,20,0.1,13,19,0.684
4/5/2015,0,LAL,LAC,L ,78,106,240,29,75,0.387,22,58,0.379,7,17,0.412,13,22,0.591,40,75,0.533,25,48,0.521,15,27,0.556,11,18,0.611
4/5/2015,9,NYK,PHI,W ,101,91,240,37,72,0.514,34,59,0.576,3,13,0.231,24,29,0.828,38,99,0.384,28,67,0.418,10,32,0.313,5,8,0.625
4/5/2015,2,OKC,HOU,L ,112,115,240,40,92,0.435,26,62,0.419,14,30,0.467,18,26,0.692,38,81,0.469,30,53,0.566,8,28,0.286,31,50,0.62
4/5/2015,11,SAC,UTA,L ,95,101,240,38,79,0.481,33,64,0.516,5,15,0.333,14,24,0.583,40,87,0.46,32,63,0.508,8,24,0.333,13,18,0.722
4/5/2015,0,SAS,GSW,W ,107,92,240,44,83,0.53,37,62,0.597,7,21,0.333,12,15,0.8,39,91,0.429,30,63,0.476,9,28,0.321,5,10,0.5
4/4/2015,0,ATL,BRK,W ,131,99,240,49,82,0.598,32,49,0.653,17,33,0.515,16,19,0.842,39,80,0.488,29,57,0.509,10,23,0.435,11,17,0.647
4/4/2015,17,CHO,PHI,W ,92,91,240,35,86,0.407,34,73,0.466,1,13,0.077,21,23,0.913,28,76,0.368,17,50,0.34,11,26,0.423,24,33,0.727
4/4/2015,0,DAL,GSW,L ,110,123,240,34,80,0.425,31,64,0.484,3,16,0.188,39,54,0.722,43,95,0.453,29,59,0.492,14,36,0.389,23,32,0.719
4/4/2015,0,DEN,LAC,L ,92,107,240,32,85,0.376,26,63,0.413,6,22,0.273,22,31,0.71,34,79,0.43,21,45,0.467,13,34,0.382,26,42,0.619
4/4/2015,9,DET,MIA,W ,99,98,240,36,73,0.493,24,47,0.511,12,26,0.462,15,23,0.652,37,77,0.481,32,57,0.561,5,20,0.25,19,26,0.731
4/4/2015,1,MEM,WAS,L ,83,92,240,34,81,0.42,33,66,0.5,1,15,0.067,14,18,0.778,38,79,0.481,30,57,0.526,8,22,0.364,8,10,0.8
4/4/2015,12,MIL,ORL,L ,90,97,240,39,89,0.438,34,73,0.466,5,16,0.313,7,13,0.538,40,86,0.465,32,65,0.492,8,21,0.381,9,13,0.692
4/4/2015,6,PHO,UTA,W ,87,85,240,30,69,0.435,25,55,0.455,5,14,0.357,22,29,0.759,29,74,0.392,22,53,0.415,7,21,0.333,20,24,0.833
4/4/2015,8,POR,NOP,W ,99,90,240,36,84,0.429,30,68,0.441,6,16,0.375,21,23,0.913,39,85,0.459,32,69,0.464,7,16,0.438,5,10,0.5
4/4/2015,14,TOR,BOS,L ,116,117,265,40,83,0.482,34,60,0.567,6,23,0.261,30,38,0.789,47,97,0.485,39,71,0.549,8,26,0.308,15,22,0.682
4/3/2015,9,BOS,MIL,L ,101,110,240,39,88,0.443,31,64,0.484,8,24,0.333,15,16,0.938,45,85,0.529,36,61,0.59,9,24,0.375,11,18,0.611
4/3/2015,14,BRK,TOR,W ,114,109,240,46,88,0.523,41,72,0.569,5,16,0.313,17,23,0.739,42,82,0.512,34,56,0.607,8,26,0.308,17,23,0.739
4/3/2015,5,CHI,DET,W ,88,82,240,33,85,0.388,29,68,0.426,4,17,0.235,18,21,0.857,32,74,0.432,26,55,0.473,6,19,0.316,12,15,0.8
4/3/2015,6,IND,CHO,W ,93,74,240,36,83,0.434,28,67,0.418,8,16,0.5,13,18,0.722,28,80,0.35,24,62,0.387,4,18,0.222,14,20,0.7
4/3/2015,2,LAL,POR,L ,77,107,240,31,82,0.378,26,68,0.382,5,14,0.357,10,17,0.588,43,88,0.489,33,62,0.532,10,26,0.385,11,11,1
4/3/2015,9,MEM,OKC,W ,100,92,240,38,80,0.475,34,59,0.576,4,21,0.19,20,28,0.714,36,88,0.409,32,71,0.451,4,17,0.235,16,26,0.615
4/3/2015,0,MIN,ORL,L ,84,97,240,29,64,0.453,28,53,0.528,1,11,0.091,25,32,0.781,40,92,0.435,34,71,0.479,6,21,0.286,11,17,0.647
4/3/2015,7,SAC,NOP,L ,95,101,240,37,78,0.474,31,61,0.508,6,17,0.353,15,25,0.6,34,87,0.391,20,58,0.345,14,29,0.483,19,28,0.679
4/3/2015,2,SAS,DEN,W ,123,93,240,47,85,0.553,33,51,0.647,14,34,0.412,15,17,0.882,40,87,0.46,34,70,0.486,6,17,0.353,7,11,0.636
4/3/2015,1,WAS,NYK,W ,101,87,240,43,93,0.462,36,77,0.468,7,16,0.438,8,12,0.667,31,84,0.369,24,63,0.381,7,21,0.333,18,20,0.9
4/2/2015,8,CLE,MIA,W ,114,88,240,40,80,0.5,25,45,0.556,15,35,0.429,19,25,0.76,32,75,0.427,25,54,0.463,7,21,0.333,17,21,0.81
4/2/2015,6,DAL,HOU,L ,101,108,240,37,84,0.44,29,58,0.5,8,26,0.308,19,27,0.704,34,77,0.442,23,46,0.5,11,31,0.355,29,40,0.725
4/2/2015,11,GSW,PHO,W ,107,106,240,43,93,0.462,33,67,0.493,10,26,0.385,11,17,0.647,42,90,0.467,37,71,0.521,5,19,0.263,17,26,0.654
4/1/2015,4,BOS,IND,W ,100,87,240,39,86,0.453,33,59,0.559,6,27,0.222,16,18,0.889,34,81,0.42,28,66,0.424,6,15,0.4,13,23,0.565
4/1/2015,0,CHO,DET,W ,102,78,240,38,90,0.422,29,68,0.426,9,22,0.409,17,24,0.708,31,88,0.352,26,66,0.394,5,22,0.227,11,18,0.611
4/1/2015,5,HOU,SAC,W ,115,111,240,41,89,0.461,23,49,0.469,18,40,0.45,15,25,0.6,48,96,0.5,41,82,0.5,7,14,0.5,8,16,0.5
4/1/2015,9,LAL,NOP,L ,92,113,240,37,83,0.446,32,67,0.478,5,16,0.313,13,21,0.619,44,78,0.564,35,62,0.565,9,16,0.563,16,21,0.762
4/1/2015,6,MIL,CHI,W ,95,91,240,37,89,0.416,29,68,0.426,8,21,0.381,13,18,0.722,31,74,0.419,26,48,0.542,5,26,0.192,24,37,0.649
4/1/2015,1,MIN,TOR,L ,99,113,240,41,77,0.532,36,63,0.571,5,14,0.357,12,19,0.632,42,76,0.553,29,46,0.63,13,30,0.433,16,23,0.696
4/1/2015,0,NYK,BRK,L ,98,100,240,37,81,0.457,26,58,0.448,11,23,0.478,13,15,0.867,41,81,0.506,32,65,0.492,9,16,0.563,9,12,0.75
4/1/2015,12,OKC,DAL,L ,131,135,240,45,93,0.484,31,62,0.5,14,31,0.452,27,33,0.818,56,91,0.615,52,76,0.684,4,15,0.267,19,24,0.792
4/1/2015,4,ORL,SAS,L ,91,103,240,39,93,0.419,34,76,0.447,5,17,0.294,8,9,0.889,35,86,0.407,22,57,0.386,13,29,0.448,20,23,0.87
4/1/2015,1,POR,LAC,L ,122,126,240,45,89,0.506,32,64,0.5,13,25,0.52,19,25,0.76,46,86,0.535,31,58,0.534,15,28,0.536,19,24,0.792
4/1/2015,6,UTA,DEN,W ,98,84,240,37,77,0.481,28,54,0.519,9,23,0.391,15,24,0.625,33,95,0.347,26,62,0.419,7,33,0.212,11,12,0.917
4/1/2015,0,WAS,PHI,W ,106,93,240,44,76,0.579,40,64,0.625,4,12,0.333,14,22,0.636,36,91,0.396,26,57,0.456,10,34,0.294,11,17,0.647
3/31/2015,9,BRK,IND,W ,111,106,240,40,80,0.5,31,62,0.5,9,18,0.5,22,28,0.786,37,82,0.451,25,59,0.424,12,23,0.522,20,24,0.833
3/31/2015,8,DET,ATL,W ,105,95,240,41,83,0.494,30,54,0.556,11,29,0.379,12,17,0.706,40,84,0.476,32,59,0.542,8,25,0.32,7,10,0.7
3/31/2015,5,LAC,GSW,L ,106,110,240,36,82,0.439,30,60,0.5,6,22,0.273,28,33,0.848,38,85,0.447,30,64,0.469,8,21,0.381,26,34,0.765
3/31/2015,4,MIA,SAS,L ,81,95,240,32,79,0.405,27,64,0.422,5,15,0.333,12,12,1,37,74,0.5,29,56,0.518,8,18,0.444,13,17,0.765
3/30/2015,2,ATL,MIL,W ,101,88,240,36,79,0.456,27,50,0.54,9,29,0.31,20,24,0.833,34,75,0.453,30,58,0.517,4,17,0.235,16,23,0.696
3/30/2015,3,CHO,BOS,L ,104,116,240,40,85,0.471,33,59,0.559,7,26,0.269,17,19,0.895,45,89,0.506,36,63,0.571,9,26,0.346,17,23,0.739
3/30/2015,0,MEM,SAC,W ,97,83,240,38,83,0.458,30,60,0.5,8,23,0.348,13,17,0.765,33,81,0.407,28,65,0.431,5,16,0.313,12,20,0.6
3/30/2015,4,MIN,UTA,L ,84,104,240,28,76,0.368,22,60,0.367,6,16,0.375,22,27,0.815,39,82,0.476,29,49,0.592,10,33,0.303,16,18,0.889
3/30/2015,7,PHI,LAL,L ,111,113,265,39,96,0.406,29,66,0.439,10,30,0.333,23,38,0.605,40,82,0.488,30,61,0.492,10,21,0.476,23,30,0.767
3/30/2015,1,POR,PHO,W ,109,86,240,44,86,0.512,32,59,0.542,12,27,0.444,9,10,0.9,38,87,0.437,35,71,0.493,3,16,0.188,7,10,0.7
3/30/2015,13,TOR,HOU,W ,99,96,240,35,78,0.449,27,56,0.482,8,22,0.364,21,27,0.778,35,84,0.417,27,57,0.474,8,27,0.296,18,31,0.581
3/29/2015,0,BOS,LAC,L ,106,119,240,39,93,0.419,31,62,0.5,8,31,0.258,20,23,0.87,41,84,0.488,28,52,0.538,13,32,0.406,24,40,0.6
3/29/2015,0,BRK,LAL,W ,107,99,240,42,87,0.483,34,59,0.576,8,28,0.286,15,21,0.714,42,91,0.462,36,73,0.493,6,18,0.333,9,11,0.818
3/29/2015,4,CLE,PHI,W ,87,86,240,33,85,0.388,24,62,0.387,9,23,0.391,12,18,0.667,34,84,0.405,24,54,0.444,10,30,0.333,8,15,0.533
3/29/2015,9,IND,DAL,W ,104,99,240,38,76,0.5,28,59,0.475,10,17,0.588,18,26,0.692,40,90,0.444,34,75,0.453,6,15,0.4,13,19,0.684
3/29/2015,1,MIA,DET,W ,109,102,240,39,82,0.476,32,64,0.5,7,18,0.389,24,29,0.828,40,83,0.482,32,58,0.552,8,25,0.32,14,22,0.636
3/29/2015,0,NOP,MIN,W ,110,88,240,43,75,0.573,37,62,0.597,6,13,0.462,18,24,0.75,32,75,0.427,30,63,0.476,2,12,0.167,22,24,0.917
3/29/2015,6,PHO,OKC,L ,97,109,240,37,82,0.451,32,60,0.533,5,22,0.227,18,24,0.75,40,86,0.465,30,60,0.5,10,26,0.385,19,26,0.731
3/29/2015,0,SAS,MEM,W ,103,89,240,42,83,0.506,38,66,0.576,4,17,0.235,15,18,0.833,36,82,0.439,30,68,0.441,6,14,0.429,11,12,0.917
3/29/2015,3,WAS,HOU,L ,91,99,240,29,75,0.387,25,60,0.417,4,15,0.267,29,37,0.784,34,80,0.425,25,51,0.49,9,29,0.31,22,33,0.667
3/28/2015,2,CHI,NYK,W ,111,80,240,43,84,0.512,37,67,0.552,6,17,0.353,19,22,0.864,30,79,0.38,26,62,0.419,4,17,0.235,16,19,0.842
3/28/2015,7,CHO,ATL,W ,115,100,240,42,80,0.525,30,54,0.556,12,26,0.462,19,22,0.864,37,86,0.43,22,56,0.393,15,30,0.5,11,14,0.786
3/28/2015,6,MIL,GSW,L ,95,108,240,33,87,0.379,31,72,0.431,2,15,0.133,27,32,0.844,42,82,0.512,30,57,0.526,12,25,0.48,12,14,0.857
3/28/2015,8,POR,DEN,W ,120,114,240,48,85,0.565,40,67,0.597,8,18,0.444,16,18,0.889,43,92,0.467,34,68,0.5,9,24,0.375,19,22,0.864
3/28/2015,4,UTA,OKC,W ,94,89,240,32,84,0.381,26,55,0.473,6,29,0.207,24,35,0.686,31,73,0.425,25,57,0.439,6,16,0.375,21,32,0.656
3/27/2015,0,ATL,MIA,W ,99,86,240,37,72,0.514,31,54,0.574,6,18,0.333,19,24,0.792,32,82,0.39,21,47,0.447,11,35,0.314,11,15,0.733
3/27/2015,9,BRK,CLE,W ,106,98,240,40,86,0.465,31,63,0.492,9,23,0.391,17,19,0.895,37,81,0.457,29,51,0.569,8,30,0.267,16,20,0.8
3/27/2015,0,DEN,UTA,W ,107,91,240,39,76,0.513,26,52,0.5,13,24,0.542,16,23,0.696,32,81,0.395,27,54,0.5,5,27,0.185,22,31,0.71
3/27/2015,0,HOU,MIN,W ,120,110,240,44,83,0.53,24,39,0.615,20,44,0.455,12,17,0.706,37,76,0.487,31,62,0.5,6,14,0.429,30,34,0.882
3/27/2015,3,MEM,GSW,L ,84,107,240,34,76,0.447,29,63,0.46,5,13,0.385,11,15,0.733,39,90,0.433,23,59,0.39,16,31,0.516,13,17,0.765
3/27/2015,5,NOP,SAC,W ,102,88,240,43,84,0.512,34,64,0.531,9,20,0.45,7,12,0.583,35,79,0.443,28,64,0.438,7,15,0.467,11,18,0.611
3/27/2015,5,NYK,BOS,L ,92,96,240,38,87,0.437,31,63,0.492,7,24,0.292,9,14,0.643,29,69,0.42,25,49,0.51,4,20,0.2,34,43,0.791
3/27/2015,9,ORL,DET,L ,97,111,240,43,82,0.524,40,67,0.597,3,15,0.2,8,8,1,42,90,0.467,35,72,0.486,7,18,0.389,20,27,0.741
3/27/2015,0,PHI,LAC,L ,98,119,240,36,86,0.419,25,55,0.455,11,31,0.355,15,27,0.556,44,82,0.537,32,53,0.604,12,29,0.414,19,31,0.613
3/27/2015,5,PHO,POR,L ,81,87,240,32,87,0.368,26,67,0.388,6,20,0.3,11,12,0.917,36,89,0.404,29,63,0.46,7,26,0.269,8,18,0.444
3/27/2015,0,SAS,DAL,W ,94,76,240,37,84,0.44,28,58,0.483,9,26,0.346,11,14,0.786,31,82,0.378,27,64,0.422,4,18,0.222,10,15,0.667
3/27/2015,6,TOR,LAL,W ,94,83,240,36,75,0.48,29,57,0.509,7,18,0.389,15,21,0.714,29,84,0.345,25,67,0.373,4,17,0.235,21,29,0.724
3/27/2015,8,WAS,CHO,W ,110,107,290,44,113,0.389,35,88,0.398,9,25,0.36,13,22,0.591,36,104,0.346,28,79,0.354,8,25,0.32,27,35,0.771
3/26/2015,0,MIL,IND,W ,111,107,240,39,73,0.534,30,54,0.556,9,19,0.474,24,34,0.706,30,71,0.423,16,41,0.39,14,30,0.467,33,43,0.767
3/25/2015,7,BOS,MIA,L ,86,93,240,28,69,0.406,23,50,0.46,5,19,0.263,25,37,0.676,34,77,0.442,25,53,0.472,9,24,0.375,16,23,0.696
3/25/2015,7,CHO,BRK,L ,88,91,240,36,91,0.396,33,79,0.418,3,12,0.25,13,20,0.65,39,91,0.429,36,77,0.468,3,14,0.214,10,11,0.909
3/25/2015,6,DEN,PHI,L ,85,99,240,29,84,0.345,21,55,0.382,8,29,0.276,19,27,0.704,35,84,0.417,21,50,0.42,14,34,0.412,15,22,0.682
3/25/2015,3,MEM,CLE,L ,89,111,240,37,85,0.435,33,68,0.485,4,17,0.235,11,16,0.688,43,84,0.512,29,50,0.58,14,34,0.412,11,13,0.846
3/25/2015,11,MIN,LAL,L ,99,101,265,33,78,0.423,27,56,0.482,6,22,0.273,27,30,0.9,39,92,0.424,33,66,0.5,6,26,0.231,17,18,0.944
3/25/2015,3,NOP,HOU,L ,93,95,240,34,75,0.453,29,60,0.483,5,15,0.333,20,32,0.625,40,81,0.494,34,59,0.576,6,22,0.273,9,12,0.75
3/25/2015,0,NYK,LAC,L ,80,111,240,29,82,0.354,24,59,0.407,5,23,0.217,17,19,0.895,44,78,0.564,33,50,0.66,11,28,0.393,12,18,0.667
3/25/2015,2,ORL,ATL,L ,83,95,240,32,78,0.41,29,62,0.468,3,16,0.188,16,20,0.8,39,90,0.433,29,59,0.492,10,31,0.323,7,10,0.7
3/25/2015,15,PHO,SAC,L ,99,108,240,38,87,0.437,32,62,0.516,6,25,0.24,17,26,0.654,40,81,0.494,32,60,0.533,8,21,0.381,20,23,0.87
3/25/2015,5,SAS,OKC,W ,130,91,240,51,88,0.58,38,67,0.567,13,21,0.619,15,19,0.789,36,90,0.4,30,72,0.417,6,18,0.333,13,14,0.929
3/25/2015,4,TOR,CHI,L ,103,116,240,39,83,0.47,30,62,0.484,9,21,0.429,16,19,0.842,45,74,0.608,33,51,0.647,12,23,0.522,14,17,0.824
3/25/2015,10,UTA,POR,L ,89,92,240,35,80,0.438,31,64,0.484,4,16,0.25,15,23,0.652,34,81,0.42,27,54,0.5,7,27,0.259,17,20,0.85
3/25/2015,8,WAS,IND,L ,101,103,240,33,75,0.44,28,61,0.459,5,14,0.357,30,38,0.789,38,85,0.447,29,59,0.492,9,26,0.346,18,28,0.643
3/24/2015,7,DAL,SAS,W ,101,94,240,42,87,0.483,35,65,0.538,7,22,0.318,10,13,0.769,36,85,0.424,28,57,0.491,8,28,0.286,14,18,0.778
3/24/2015,8,DET,TOR,W ,108,104,240,40,93,0.43,28,64,0.438,12,29,0.414,16,24,0.667,35,75,0.467,28,52,0.538,7,23,0.304,27,29,0.931
3/24/2015,10,MIL,MIA,W ,89,88,240,36,87,0.414,32,70,0.457,4,17,0.235,13,17,0.765,33,75,0.44,25,56,0.446,8,19,0.421,14,18,0.778
3/24/2015,2,OKC,LAL,W ,127,117,240,48,86,0.558,37,65,0.569,11,21,0.524,20,23,0.87,44,85,0.518,35,66,0.53,9,19,0.474,20,27,0.741
3/24/2015,4,POR,GSW,L ,108,122,240,39,92,0.424,24,58,0.414,15,34,0.441,15,19,0.789,50,83,0.602,38,57,0.667,12,26,0.462,10,11,0.909
3/24/2015,10,SAC,PHI,W ,107,106,240,35,97,0.361,28,77,0.364,7,20,0.35,30,38,0.789,40,81,0.494,27,53,0.509,13,28,0.464,13,21,0.619
3/23/2015,1,BRK,BOS,L ,91,110,240,32,89,0.36,31,72,0.431,1,17,0.059,26,30,0.867,47,92,0.511,41,70,0.586,6,22,0.273,10,14,0.714
3/23/2015,12,CHI,CHO,W ,98,86,240,37,82,0.451,34,66,0.515,3,16,0.188,21,29,0.724,28,81,0.346,20,61,0.328,8,20,0.4,22,28,0.786
3/23/2015,10,GSW,WAS,W ,107,76,240,39,95,0.411,26,62,0.419,13,33,0.394,16,21,0.762,27,81,0.333,24,70,0.343,3,11,0.273,19,26,0.731
3/23/2015,0,IND,HOU,L ,100,110,240,40,90,0.444,32,66,0.485,8,24,0.333,12,19,0.632,31,65,0.477,18,41,0.439,13,24,0.542,35,37,0.946
3/23/2015,4,NYK,MEM,L ,82,103,240,32,76,0.421,28,58,0.483,4,18,0.222,14,17,0.824,41,79,0.519,34,67,0.507,7,12,0.583,14,19,0.737
3/23/2015,11,UTA,MIN,L ,104,106,265,38,87,0.437,29,59,0.492,9,28,0.321,19,31,0.613,37,78,0.474,25,59,0.424,12,19,0.632,20,25,0.8
3/22/2015,0,ATL,SAS,L ,95,114,240,38,80,0.475,26,56,0.464,12,24,0.5,7,7,1,46,82,0.561,39,65,0.6,7,17,0.412,15,17,0.882
3/22/2015,14,BOS,DET,L ,97,105,265,38,105,0.362,30,78,0.385,8,27,0.296,13,17,0.765,39,89,0.438,30,63,0.476,9,26,0.346,18,30,0.6
3/22/2015,9,LAC,NOP,W ,107,100,240,42,91,0.462,35,68,0.515,7,23,0.304,16,23,0.696,38,75,0.507,26,53,0.491,12,22,0.545,12,16,0.75
3/22/2015,12,LAL,PHI,W ,101,87,240,39,81,0.481,34,67,0.507,5,14,0.357,18,22,0.818,32,89,0.36,23,62,0.371,9,27,0.333,14,21,0.667
3/22/2015,5,MIL,CLE,L ,90,108,240,38,70,0.543,35,58,0.603,3,12,0.25,11,14,0.786,42,84,0.5,29,53,0.547,13,31,0.419,11,16,0.688
3/22/2015,1,MIN,CHO,L ,98,109,240,41,74,0.554,37,63,0.587,4,11,0.364,12,16,0.75,45,89,0.506,39,71,0.549,6,18,0.333,13,16,0.813
3/22/2015,1,OKC,MIA,W ,93,75,240,40,90,0.444,34,72,0.472,6,18,0.333,7,13,0.538,32,81,0.395,29,63,0.46,3,18,0.167,8,15,0.533
3/22/2015,5,ORL,DEN,L ,100,119,240,41,85,0.482,37,68,0.544,4,17,0.235,14,17,0.824,42,90,0.467,30,62,0.484,12,28,0.429,23,30,0.767
3/22/2015,6,PHO,DAL,W ,98,92,240,39,76,0.513,33,55,0.6,6,21,0.286,14,23,0.609,37,96,0.385,32,77,0.416,5,19,0.263,13,22,0.591
3/22/2015,9,SAC,WAS,W ,109,86,240,40,79,0.506,32,62,0.516,8,17,0.471,21,23,0.913,35,87,0.402,32,70,0.457,3,17,0.176,13,18,0.722
3/22/2015,0,TOR,NYK,W ,106,89,240,39,75,0.52,35,64,0.547,4,11,0.364,24,29,0.828,35,84,0.417,27,65,0.415,8,19,0.421,11,16,0.688
3/21/2015,4,DET,CHI,W ,107,91,240,44,90,0.489,33,64,0.516,11,26,0.423,8,10,0.8,33,77,0.429,27,56,0.482,6,21,0.286,19,24,0.792
3/21/2015,1,GSW,UTA,W ,106,91,240,38,78,0.487,30,60,0.5,8,18,0.444,22,26,0.846,32,73,0.438,22,51,0.431,10,22,0.455,17,21,0.81
3/21/2015,7,HOU,PHO,L ,102,117,240,41,87,0.471,31,53,0.585,10,34,0.294,10,12,0.833,46,92,0.5,38,77,0.494,8,15,0.533,17,24,0.708
3/21/2015,6,IND,BRK,L ,111,123,240,45,90,0.5,37,67,0.552,8,23,0.348,13,18,0.722,46,75,0.613,40,63,0.635,6,12,0.5,25,31,0.806
3/21/2015,6,MEM,POR,W ,97,86,240,37,89,0.416,26,71,0.366,11,18,0.611,12,16,0.75,33,76,0.434,27,54,0.5,6,22,0.273,14,15,0.933
3/20/2015,14,BRK,MIL,W ,129,127,315,46,107,0.43,35,82,0.427,11,25,0.44,26,34,0.765,49,129,0.38,41,113,0.363,8,16,0.5,21,29,0.724
3/20/2015,6,CHI,TOR,W ,108,92,240,42,79,0.532,33,51,0.647,9,28,0.321,15,17,0.882,30,79,0.38,20,54,0.37,10,25,0.4,22,26,0.846
3/20/2015,14,CLE,IND,W ,95,92,240,35,82,0.427,26,56,0.464,9,26,0.346,16,21,0.762,36,84,0.429,28,64,0.438,8,20,0.4,12,13,0.923
3/20/2015,8,DAL,MEM,L ,101,112,240,34,76,0.447,26,54,0.481,8,22,0.364,25,36,0.694,41,77,0.532,33,59,0.559,8,18,0.444,22,32,0.688
3/20/2015,2,GSW,NOP,W ,112,96,240,44,88,0.5,39,69,0.565,5,19,0.263,19,23,0.826,33,77,0.429,22,55,0.4,11,22,0.5,19,22,0.864
3/20/2015,1,LAC,WAS,W ,113,99,240,45,86,0.523,33,63,0.524,12,23,0.522,11,17,0.647,37,86,0.43,31,67,0.463,6,19,0.316,19,23,0.826
3/20/2015,4,MIA,DEN,W ,108,91,240,43,81,0.531,36,65,0.554,7,16,0.438,15,19,0.789,37,79,0.468,30,52,0.577,7,27,0.259,10,19,0.526
3/20/2015,7,OKC,ATL,W ,123,115,240,43,84,0.512,30,54,0.556,13,30,0.433,24,26,0.923,41,82,0.5,28,53,0.528,13,29,0.448,20,25,0.8
3/20/2015,6,ORL,POR,W ,111,104,240,43,94,0.457,38,82,0.463,5,12,0.417,20,24,0.833,38,80,0.475,31,56,0.554,7,24,0.292,21,24,0.875
3/20/2015,3,PHI,NYK,W ,97,81,240,37,88,0.42,26,58,0.448,11,30,0.367,12,15,0.8,25,69,0.362,17,53,0.321,8,16,0.5,23,26,0.885
3/20/2015,0,SAC,CHO,W ,101,91,240,37,78,0.474,28,57,0.491,9,21,0.429,18,25,0.72,36,91,0.396,30,73,0.411,6,18,0.333,13,16,0.813
3/20/2015,0,SAS,BOS,W ,101,89,240,38,81,0.469,33,58,0.569,5,23,0.217,20,23,0.87,35,88,0.398,30,68,0.441,5,20,0.25,14,20,0.7
3/19/2015,5,HOU,DEN,W ,118,108,240,37,83,0.446,25,53,0.472,12,30,0.4,32,40,0.8,42,93,0.452,29,57,0.509,13,36,0.361,11,19,0.579
3/19/2015,17,LAL,UTA,L ,73,80,240,31,77,0.403,28,66,0.424,3,11,0.273,8,17,0.471,25,62,0.403,16,37,0.432,9,25,0.36,21,31,0.677
3/19/2015,12,NYK,MIN,L ,92,95,265,40,97,0.412,36,77,0.468,4,20,0.2,8,10,0.8,34,83,0.41,32,71,0.451,2,12,0.167,25,30,0.833
3/19/2015,5,PHO,NOP,W ,74,72,240,29,83,0.349,27,61,0.443,2,22,0.091,14,21,0.667,31,83,0.373,26,65,0.4,5,18,0.278,5,10,0.5
3/18/2015,5,CHI,IND,W ,103,86,240,34,82,0.415,24,58,0.414,10,24,0.417,25,28,0.893,32,81,0.395,26,62,0.419,6,19,0.316,16,21,0.762
3/18/2015,1,CLE,BRK,W ,117,92,240,45,82,0.549,30,53,0.566,15,29,0.517,12,20,0.6,36,80,0.45,31,60,0.517,5,20,0.25,15,21,0.714
3/18/2015,0,DAL,ORL,W ,107,102,240,39,80,0.488,26,49,0.531,13,31,0.419,16,24,0.667,40,87,0.46,31,59,0.525,9,28,0.321,13,14,0.929
3/18/2015,3,GSW,ATL,W ,114,95,240,44,84,0.524,30,54,0.556,14,30,0.467,12,20,0.6,31,87,0.356,23,65,0.354,8,22,0.364,25,30,0.833
3/18/2015,8,MIA,POR,W ,108,104,240,46,87,0.529,39,77,0.506,7,10,0.7,9,14,0.643,41,81,0.506,31,55,0.564,10,26,0.385,12,21,0.571
3/18/2015,5,MIL,SAS,L ,103,114,240,39,80,0.488,32,66,0.485,7,14,0.5,18,24,0.75,38,76,0.5,30,56,0.536,8,20,0.4,30,38,0.789
3/18/2015,6,OKC,BOS,W ,122,118,240,42,88,0.477,37,69,0.536,5,19,0.263,33,39,0.846,44,84,0.524,31,50,0.62,13,34,0.382,17,28,0.607
3/18/2015,5,PHI,DET,W ,94,83,240,36,84,0.429,25,57,0.439,11,27,0.407,11,18,0.611,29,88,0.33,21,62,0.339,8,26,0.308,17,19,0.895
3/18/2015,8,SAC,LAC,L ,105,116,240,38,79,0.481,35,62,0.565,3,17,0.176,26,32,0.813,45,88,0.511,28,51,0.549,17,37,0.459,9,13,0.692
3/18/2015,9,TOR,MIN,W ,105,100,240,35,79,0.443,23,50,0.46,12,29,0.414,23,27,0.852,42,87,0.483,36,70,0.514,6,17,0.353,10,15,0.667
3/18/2015,9,UTA,WAS,L ,84,88,240,34,82,0.415,30,60,0.5,4,22,0.182,12,24,0.5,33,63,0.524,27,52,0.519,6,11,0.545,16,23,0.696
3/17/2015,8,DET,MEM,W ,105,95,240,39,83,0.47,27,50,0.54,12,33,0.364,15,22,0.682,35,80,0.438,25,62,0.403,10,18,0.556,15,17,0.882
3/17/2015,24,HOU,ORL,W ,107,94,240,39,78,0.5,28,51,0.549,11,27,0.407,18,27,0.667,38,89,0.427,32,67,0.478,6,22,0.273,12,17,0.706
3/17/2015,5,LAC,CHO,W ,99,92,240,35,77,0.455,26,53,0.491,9,24,0.375,20,28,0.714,32,79,0.405,27,65,0.415,5,14,0.357,23,29,0.793
3/17/2015,4,NOP,MIL,W ,85,84,240,29,83,0.349,21,58,0.362,8,25,0.32,19,26,0.731,32,86,0.372,28,66,0.424,4,20,0.2,16,21,0.762
3/17/2015,7,NYK,SAS,W ,104,100,265,41,91,0.451,38,77,0.494,3,14,0.214,19,27,0.704,36,94,0.383,33,80,0.413,3,14,0.214,25,30,0.833
3/16/2015,0,BOS,PHI,W ,108,89,240,44,88,0.5,36,68,0.529,8,20,0.4,12,15,0.8,34,84,0.405,26,60,0.433,8,24,0.333,13,24,0.542
3/16/2015,2,DAL,OKC,W ,119,115,240,42,89,0.472,32,64,0.5,10,25,0.4,25,35,0.714,40,90,0.444,33,64,0.516,7,26,0.269,28,35,0.8
3/16/2015,8,GSW,LAL,W ,108,105,240,40,84,0.476,33,57,0.579,7,27,0.259,21,23,0.913,39,85,0.459,31,70,0.443,8,15,0.533,19,21,0.905
3/16/2015,0,IND,TOR,L ,98,117,240,38,88,0.432,36,69,0.522,2,19,0.105,20,25,0.8,39,82,0.476,27,59,0.458,12,23,0.522,27,33,0.818
3/16/2015,4,MEM,DEN,W ,92,81,240,33,80,0.413,31,71,0.437,2,9,0.222,24,28,0.857,30,81,0.37,22,63,0.349,8,18,0.444,13,21,0.619
3/16/2015,1,MIA,CLE,W ,106,92,240,42,76,0.553,38,61,0.623,4,15,0.267,18,22,0.818,30,79,0.38,19,46,0.413,11,33,0.333,21,27,0.778
3/16/2015,2,MIN,BRK,L ,106,122,240,41,88,0.466,32,73,0.438,9,15,0.6,15,17,0.882,52,90,0.578,47,77,0.61,5,13,0.385,13,17,0.765
3/16/2015,8,SAC,ATL,L ,103,110,240,38,81,0.469,31,61,0.508,7,20,0.35,20,25,0.8,38,84,0.452,26,53,0.491,12,31,0.387,22,30,0.733
3/16/2015,0,UTA,CHO,W ,94,66,240,33,78,0.423,18,54,0.333,15,24,0.625,13,19,0.684,23,78,0.295,18,59,0.305,5,19,0.263,15,18,0.833
3/16/2015,1,WAS,POR,W ,105,97,240,41,82,0.5,34,70,0.486,7,12,0.583,16,26,0.615,36,89,0.404,28,61,0.459,8,28,0.286,17,20,0.85
3/15/2015,5,LAC,HOU,L ,98,100,240,36,82,0.439,24,56,0.429,12,26,0.462,14,24,0.583,32,86,0.372,25,56,0.446,7,30,0.233,29,36,0.806
3/15/2015,2,LAL,ATL,L ,86,91,240,34,85,0.4,27,67,0.403,7,18,0.389,11,15,0.733,34,76,0.447,29,53,0.547,5,23,0.217,18,27,0.667
3/15/2015,13,NOP,DEN,L ,111,118,290,46,99,0.465,40,77,0.519,6,22,0.273,13,21,0.619,46,104,0.442,36,73,0.493,10,31,0.323,16,20,0.8
3/15/2015,12,OKC,CHI,W ,109,100,240,40,87,0.46,32,66,0.485,8,21,0.381,21,30,0.7,37,83,0.446,28,54,0.519,9,29,0.31,17,24,0.708
3/15/2015,1,ORL,CLE,L ,108,123,240,42,88,0.477,33,69,0.478,9,19,0.474,15,27,0.556,45,76,0.592,27,41,0.659,18,35,0.514,15,19,0.789
3/15/2015,8,PHO,NYK,W ,102,89,240,41,83,0.494,35,65,0.538,6,18,0.333,14,23,0.609,32,73,0.438,27,59,0.458,5,14,0.357,20,30,0.667
3/15/2015,0,SAS,MIN,W ,123,97,240,49,84,0.583,37,62,0.597,12,22,0.545,13,15,0.867,38,86,0.442,31,71,0.437,7,15,0.467,14,18,0.778
3/15/2015,9,TOR,POR,L ,97,113,240,37,78,0.474,32,60,0.533,5,18,0.278,18,23,0.783,45,86,0.523,32,57,0.561,13,29,0.448,10,16,0.625
3/14/2015,5,GSW,NYK,W ,125,94,240,45,90,0.5,26,56,0.464,19,34,0.559,16,17,0.941,38,96,0.396,29,71,0.408,9,25,0.36,9,16,0.563
3/14/2015,6,IND,BOS,L ,89,93,240,34,85,0.4,25,61,0.41,9,24,0.375,12,15,0.8,35,83,0.422,27,55,0.491,8,28,0.286,15,21,0.714
3/14/2015,2,MEM,MIL,W ,96,83,240,37,78,0.474,29,64,0.453,8,14,0.571,14,16,0.875,30,72,0.417,25,53,0.472,5,19,0.263,18,27,0.667
3/14/2015,14,PHI,BRK,L ,87,94,240,35,94,0.372,27,57,0.474,8,37,0.216,9,14,0.643,37,84,0.44,35,67,0.522,2,17,0.118,18,26,0.692
3/14/2015,8,UTA,DET,W ,88,85,240,33,69,0.478,27,55,0.491,6,14,0.429,16,24,0.667,32,84,0.381,24,61,0.393,8,23,0.348,13,22,0.591
3/14/2015,1,WAS,SAC,W ,113,97,240,43,81,0.531,30,55,0.545,13,26,0.5,14,17,0.824,35,77,0.455,29,58,0.5,6,19,0.316,21,28,0.75
3/13/2015,5,BOS,ORL,W ,95,88,240,37,86,0.43,27,60,0.45,10,26,0.385,11,20,0.55,34,80,0.425,28,60,0.467,6,20,0.3,14,28,0.5
3/13/2015,2,CHO,CHI,W ,101,91,240,33,89,0.371,26,70,0.371,7,19,0.368,28,33,0.848,31,82,0.378,16,50,0.32,15,32,0.469,14,19,0.737
3/13/2015,2,DAL,LAC,W ,129,99,240,51,84,0.607,35,56,0.625,16,28,0.571,11,16,0.688,41,82,0.5,29,50,0.58,12,32,0.375,5,12,0.417
3/13/2015,4,DEN,GSW,W ,114,103,240,41,82,0.5,33,65,0.508,8,17,0.471,24,37,0.649,39,92,0.424,31,73,0.425,8,19,0.421,17,22,0.773
3/13/2015,5,OKC,MIN,W ,113,99,240,44,101,0.436,33,77,0.429,11,24,0.458,14,14,1,34,78,0.436,31,66,0.47,3,12,0.25,28,31,0.903
3/13/2015,11,PHI,SAC,W ,114,107,240,45,95,0.474,36,63,0.571,9,32,0.281,15,23,0.652,35,87,0.402,31,73,0.425,4,14,0.286,33,40,0.825
3/13/2015,15,PHO,ATL,L ,87,96,240,32,78,0.41,22,52,0.423,10,26,0.385,13,21,0.619,39,83,0.47,31,65,0.477,8,18,0.444,10,12,0.833
3/13/2015,2,POR,DET,W ,118,99,240,46,80,0.575,35,59,0.593,11,21,0.524,15,17,0.882,41,91,0.451,34,66,0.515,7,25,0.28,10,12,0.833
3/13/2015,2,TOR,MIA,W ,102,92,240,34,79,0.43,22,46,0.478,12,33,0.364,22,31,0.71,35,79,0.443,30,56,0.536,5,23,0.217,17,24,0.708
3/12/2015,8,IND,MIL,W ,109,103,265,39,79,0.494,30,57,0.526,9,22,0.409,22,28,0.786,35,91,0.385,31,77,0.403,4,14,0.286,29,36,0.806
3/12/2015,8,LAL,NYK,L ,94,101,240,38,90,0.422,33,72,0.458,5,18,0.278,13,21,0.619,36,77,0.468,27,59,0.458,9,18,0.5,20,26,0.769
3/12/2015,13,SAS,CLE,L ,125,128,265,49,87,0.563,41,61,0.672,8,26,0.308,19,27,0.704,44,91,0.484,30,65,0.462,14,26,0.538,26,30,0.867
3/12/2015,0,UTA,HOU,W ,109,91,240,44,92,0.478,33,59,0.559,11,33,0.333,10,17,0.588,34,79,0.43,27,47,0.574,7,32,0.219,16,24,0.667
3/12/2015,1,WAS,MEM,W ,107,87,240,40,80,0.5,35,63,0.556,5,17,0.294,22,31,0.71,31,80,0.388,28,61,0.459,3,19,0.158,22,30,0.733
3/11/2015,14,BOS,MEM,W ,95,92,240,37,85,0.435,29,58,0.5,8,27,0.296,13,17,0.765,37,78,0.474,32,66,0.485,5,12,0.417,13,13,1
3/11/2015,16,CHO,SAC,L ,106,113,240,42,93,0.452,36,75,0.48,6,18,0.333,16,26,0.615,40,85,0.471,32,65,0.492,8,20,0.4,25,30,0.833
3/11/2015,1,DEN,ATL,W ,115,102,240,42,84,0.5,29,53,0.547,13,31,0.419,18,20,0.9,34,81,0.42,25,54,0.463,9,27,0.333,25,27,0.926
3/11/2015,7,GSW,DET,W ,105,98,240,44,84,0.524,37,64,0.578,7,20,0.35,10,13,0.769,42,98,0.429,38,86,0.442,4,12,0.333,10,12,0.833
3/11/2015,7,MIA,BRK,W ,104,98,240,37,81,0.457,31,60,0.517,6,21,0.286,24,38,0.632,32,73,0.438,26,56,0.464,6,17,0.353,28,39,0.718
3/11/2015,22,MIL,ORL,W ,97,91,240,39,79,0.494,31,61,0.508,8,18,0.444,11,16,0.688,34,85,0.4,24,67,0.358,10,18,0.556,13,13,1
3/11/2015,2,OKC,LAC,L ,108,120,240,33,76,0.434,21,51,0.412,12,25,0.48,30,36,0.833,35,76,0.461,20,46,0.435,15,30,0.5,35,47,0.745
3/11/2015,10,PHI,CHI,L ,95,104,265,36,104,0.346,25,63,0.397,11,41,0.268,12,25,0.48,40,87,0.46,30,63,0.476,10,24,0.417,14,20,0.7
3/11/2015,3,PHO,MIN,W ,106,97,240,45,90,0.5,39,66,0.591,6,24,0.25,10,13,0.769,36,81,0.444,35,68,0.515,1,13,0.077,24,26,0.923
3/11/2015,13,POR,HOU,W ,105,100,240,42,92,0.457,32,59,0.542,10,33,0.303,11,14,0.786,38,91,0.418,27,60,0.45,11,31,0.355,13,23,0.565
3/10/2015,2,BRK,NOP,L ,91,111,240,35,84,0.417,29,68,0.426,6,16,0.375,15,23,0.652,45,87,0.517,33,66,0.5,12,21,0.571,9,11,0.818
3/10/2015,6,DAL,CLE,L ,94,127,240,33,81,0.407,28,61,0.459,5,20,0.25,23,33,0.697,44,87,0.506,29,55,0.527,15,32,0.469,24,29,0.828
3/10/2015,1,IND,ORL,W ,118,86,240,45,85,0.529,28,51,0.549,17,34,0.5,11,12,0.917,34,92,0.37,30,75,0.4,4,17,0.235,14,20,0.7
3/10/2015,4,LAL,DET,W ,93,85,240,32,75,0.427,29,62,0.468,3,13,0.231,26,30,0.867,32,84,0.381,24,49,0.49,8,35,0.229,13,19,0.684
3/10/2015,6,SAS,TOR,W ,117,107,240,41,85,0.482,30,67,0.448,11,18,0.611,24,30,0.8,43,97,0.443,35,71,0.493,8,26,0.308,13,18,0.722
3/10/2015,12,UTA,NYK,W ,87,82,240,30,70,0.429,24,52,0.462,6,18,0.333,21,29,0.724,31,79,0.392,26,66,0.394,5,13,0.385,15,17,0.882
3/9/2015,3,ATL,SAC,W ,130,105,240,53,88,0.602,33,52,0.635,20,36,0.556,4,7,0.571,39,81,0.481,31,61,0.508,8,20,0.4,19,20,0.95
3/9/2015,10,CHI,MEM,L ,91,101,240,35,80,0.438,25,58,0.431,10,22,0.455,11,14,0.786,42,84,0.5,37,70,0.529,5,14,0.357,12,17,0.706
3/9/2015,3,CHO,WAS,L ,69,95,240,25,77,0.325,21,55,0.382,4,22,0.182,15,20,0.75,44,85,0.518,42,71,0.592,2,14,0.143,5,5,1
3/9/2015,1,DEN,NYK,W ,106,78,240,38,87,0.437,30,63,0.476,8,24,0.333,22,29,0.759,29,75,0.387,24,62,0.387,5,13,0.385,15,25,0.6
3/9/2015,3,LAC,MIN,W ,89,76,240,35,79,0.443,24,48,0.5,11,31,0.355,8,15,0.533,31,83,0.373,29,75,0.387,2,8,0.25,12,21,0.571
3/9/2015,5,MIA,BOS,L ,90,100,240,29,69,0.42,25,52,0.481,4,17,0.235,28,34,0.824,39,87,0.448,33,62,0.532,6,25,0.24,16,17,0.941
3/9/2015,9,MIL,NOP,L ,103,114,240,37,71,0.521,33,56,0.589,4,15,0.267,25,31,0.806,44,75,0.587,35,60,0.583,9,15,0.6,17,21,0.81
3/9/2015,1,PHO,GSW,L ,80,98,240,29,77,0.377,25,66,0.379,4,11,0.364,18,23,0.783,35,83,0.422,22,52,0.423,13,31,0.419,15,19,0.789
3/8/2015,10,BRK,UTA,L ,88,95,240,38,76,0.5,30,61,0.492,8,15,0.533,4,11,0.364,34,72,0.472,24,50,0.48,10,22,0.455,17,21,0.81
3/8/2015,17,DET,CHO,L ,101,108,240,39,89,0.438,36,75,0.48,3,14,0.214,20,25,0.8,41,79,0.519,35,62,0.565,6,17,0.353,20,23,0.87
3/8/2015,9,GSW,LAC,W ,106,98,240,40,80,0.5,30,58,0.517,10,22,0.455,16,23,0.696,40,83,0.482,32,58,0.552,8,25,0.32,10,14,0.714
3/8/2015,11,LAL,DAL,L ,93,100,240,38,82,0.463,36,68,0.529,2,14,0.143,15,21,0.714,38,78,0.487,29,52,0.558,9,26,0.346,15,22,0.682
3/8/2015,9,OKC,TOR,W ,108,104,240,42,82,0.512,36,61,0.59,6,21,0.286,18,25,0.72,42,98,0.429,31,71,0.437,11,27,0.407,9,9,1
3/8/2015,5,ORL,BOS,W ,103,98,240,38,87,0.437,31,65,0.477,7,22,0.318,20,30,0.667,35,89,0.393,20,55,0.364,15,34,0.441,13,16,0.813
3/8/2015,1,SAS,CHI,W ,116,105,240,44,90,0.489,35,68,0.515,9,22,0.409,19,24,0.792,37,73,0.507,32,58,0.552,5,15,0.333,26,29,0.897
3/7/2015,3,CLE,PHO,W ,89,79,240,31,75,0.413,23,55,0.418,8,20,0.4,19,23,0.826,30,84,0.357,21,59,0.356,9,25,0.36,10,14,0.714
3/7/2015,8,DEN,HOU,L ,100,114,240,38,92,0.413,29,62,0.468,9,30,0.3,15,19,0.789,40,86,0.465,30,58,0.517,10,28,0.357,24,32,0.75
3/7/2015,5,MIA,SAC,W ,114,109,265,41,80,0.513,34,56,0.607,7,24,0.292,25,33,0.758,40,88,0.455,30,63,0.476,10,25,0.4,19,24,0.792
3/7/2015,7,MIL,WAS,W ,91,85,240,36,78,0.462,26,58,0.448,10,20,0.5,9,15,0.6,31,81,0.383,22,53,0.415,9,28,0.321,14,22,0.636
3/7/2015,5,MIN,POR,W ,121,113,240,46,85,0.541,42,78,0.538,4,7,0.571,25,31,0.806,43,88,0.489,29,61,0.475,14,27,0.519,13,17,0.765
3/7/2015,6,NOP,MEM,W ,95,89,240,38,80,0.475,30,57,0.526,8,23,0.348,11,13,0.846,32,74,0.432,26,58,0.448,6,16,0.375,19,29,0.655
3/7/2015,12,NYK,IND,L ,86,92,240,30,78,0.385,27,63,0.429,3,15,0.2,23,30,0.767,30,79,0.38,23,61,0.377,7,18,0.389,25,30,0.833
3/7/2015,18,PHI,ATL,W ,92,84,240,35,95,0.368,22,58,0.379,13,37,0.351,9,17,0.529,30,77,0.39,19,52,0.365,11,25,0.44,13,16,0.813
3/6/2015,6,ATL,CLE,W ,106,97,240,43,84,0.512,37,63,0.587,6,21,0.286,14,17,0.824,29,69,0.42,16,31,0.516,13,38,0.342,26,33,0.788
3/6/2015,20,BRK,PHO,L ,100,108,265,34,97,0.351,26,75,0.347,8,22,0.364,24,29,0.828,39,91,0.429,36,65,0.554,3,26,0.115,27,35,0.771
3/6/2015,0,CHO,TOR,W ,103,94,240,40,85,0.471,35,65,0.538,5,20,0.25,18,20,0.9,37,91,0.407,30,69,0.435,7,22,0.318,13,15,0.867
3/6/2015,1,GSW,DAL,W ,104,89,240,38,81,0.469,27,58,0.466,11,23,0.478,17,19,0.895,32,87,0.368,26,67,0.388,6,20,0.3,19,26,0.731
3/6/2015,2,HOU,DET,W ,103,93,240,38,91,0.418,32,63,0.508,6,28,0.214,21,25,0.84,37,102,0.363,31,73,0.425,6,29,0.207,13,17,0.765
3/6/2015,9,IND,CHI,W ,98,84,240,34,80,0.425,28,60,0.467,6,20,0.3,24,33,0.727,31,86,0.36,26,63,0.413,5,23,0.217,17,19,0.895
3/6/2015,8,MEM,LAL,W ,97,90,240,34,77,0.442,33,66,0.5,1,11,0.091,28,33,0.848,39,84,0.464,34,72,0.472,5,12,0.417,7,9,0.778
3/6/2015,15,NOP,BOS,L ,98,104,240,38,80,0.475,30,59,0.508,8,21,0.381,14,15,0.933,36,79,0.456,26,56,0.464,10,23,0.435,22,25,0.88
3/6/2015,6,ORL,SAC,W ,119,114,240,48,85,0.565,35,61,0.574,13,24,0.542,10,12,0.833,38,85,0.447,28,58,0.483,10,27,0.37,28,38,0.737
3/6/2015,10,PHI,UTA,L ,83,89,240,32,88,0.364,22,56,0.393,10,32,0.313,9,18,0.5,27,71,0.38,21,59,0.356,6,12,0.5,29,41,0.707
3/6/2015,6,SAS,DEN,W ,120,111,240,43,79,0.544,34,55,0.618,9,24,0.375,25,33,0.758,45,86,0.523,39,69,0.565,6,17,0.353,15,23,0.652
3/6/2015,0,WAS,MIA,W ,99,97,240,38,82,0.463,31,59,0.525,7,23,0.304,16,18,0.889,37,79,0.468,27,52,0.519,10,27,0.37,13,19,0.684
3/5/2015,9,CHI,OKC,W ,108,105,240,40,87,0.46,33,62,0.532,7,25,0.28,21,26,0.808,41,88,0.466,33,68,0.485,8,20,0.4,15,19,0.789
3/5/2015,8,POR,DAL,W ,94,75,240,34,82,0.415,27,60,0.45,7,22,0.318,19,21,0.905,33,88,0.375,31,72,0.431,2,16,0.125,7,8,0.875
3/4/2015,9,BOS,UTA,W ,85,84,240,33,88,0.375,25,61,0.41,8,27,0.296,11,20,0.55,34,75,0.453,31,56,0.554,3,19,0.158,13,21,0.619
3/4/2015,0,BRK,CHO,L ,91,115,240,35,88,0.398,32,72,0.444,3,16,0.188,18,24,0.75,42,85,0.494,34,66,0.515,8,19,0.421,23,28,0.821
3/4/2015,4,GSW,MIL,W ,102,93,240,37,73,0.507,23,39,0.59,14,34,0.412,14,25,0.56,34,80,0.425,29,66,0.439,5,14,0.357,20,25,0.8
3/4/2015,7,HOU,MEM,L ,100,102,240,42,86,0.488,31,58,0.534,11,28,0.393,5,5,1,42,83,0.506,38,67,0.567,4,16,0.25,14,17,0.824
3/4/2015,0,IND,NYK,W ,105,82,240,38,80,0.475,28,58,0.483,10,22,0.455,19,24,0.792,30,76,0.395,24,60,0.4,6,16,0.375,16,23,0.696
3/4/2015,14,LAC,POR,L ,93,98,265,37,96,0.385,26,65,0.4,11,31,0.355,8,18,0.444,34,87,0.391,26,55,0.473,8,32,0.25,22,29,0.759
3/4/2015,7,MIA,LAL,W ,100,94,240,32,79,0.405,29,63,0.46,3,16,0.188,33,43,0.767,38,88,0.432,31,70,0.443,7,18,0.389,11,17,0.647
3/4/2015,5,MIN,DEN,L ,85,100,240,32,82,0.39,29,64,0.453,3,18,0.167,18,25,0.72,42,92,0.457,34,72,0.472,8,20,0.4,8,10,0.8
3/4/2015,15,NOP,DET,W ,88,85,240,37,90,0.411,35,78,0.449,2,12,0.167,12,16,0.75,38,93,0.409,36,79,0.456,2,14,0.143,7,9,0.778
3/4/2015,11,OKC,PHI,W ,123,118,265,44,96,0.458,37,75,0.493,7,21,0.333,28,34,0.824,34,96,0.354,19,61,0.311,15,35,0.429,35,44,0.795
3/4/2015,4,ORL,PHO,L ,100,105,240,41,87,0.471,36,67,0.537,5,20,0.25,13,15,0.867,37,79,0.468,29,58,0.5,8,21,0.381,23,27,0.852
3/4/2015,4,SAS,SAC,W ,112,85,240,45,85,0.529,35,62,0.565,10,23,0.435,12,16,0.75,29,78,0.372,26,69,0.377,3,9,0.333,24,34,0.706
3/4/2015,9,TOR,CLE,L ,112,120,240,43,79,0.544,33,58,0.569,10,21,0.476,16,17,0.941,40,78,0.513,25,42,0.595,15,36,0.417,25,34,0.735
3/3/2015,5,ATL,HOU,W ,104,96,240,39,86,0.453,31,57,0.544,8,29,0.276,18,21,0.857,39,90,0.433,25,49,0.51,14,41,0.341,4,9,0.444
3/3/2015,6,CHI,WAS,W ,97,92,240,33,78,0.423,24,49,0.49,9,29,0.31,22,30,0.733,35,84,0.417,27,62,0.435,8,22,0.364,14,19,0.737
3/3/2015,7,CHO,LAL,W ,104,103,240,39,79,0.494,34,66,0.515,5,13,0.385,21,31,0.677,39,86,0.453,33,69,0.478,6,17,0.353,19,21,0.905
3/3/2015,2,CLE,BOS,W ,110,79,240,43,89,0.483,33,61,0.541,10,28,0.357,14,14,1,31,88,0.352,24,60,0.4,7,28,0.25,10,13,0.769
3/3/2015,4,DEN,MIL,W ,106,95,240,39,86,0.453,27,52,0.519,12,34,0.353,16,20,0.8,35,86,0.407,25,62,0.403,10,24,0.417,15,22,0.682
3/3/2015,12,MEM,UTA,L ,82,93,240,33,82,0.402,30,71,0.423,3,11,0.273,13,19,0.684,36,80,0.45,31,55,0.564,5,25,0.2,16,19,0.842
3/3/2015,0,NYK,SAC,L ,86,124,240,30,82,0.366,26,60,0.433,4,22,0.182,22,30,0.733,41,83,0.494,31,65,0.477,10,18,0.556,32,37,0.865
3/2/2015,6,BRK,GSW,W ,110,108,240,44,89,0.494,34,68,0.5,10,21,0.476,12,16,0.75,42,90,0.467,31,60,0.517,11,30,0.367,13,18,0.722
3/2/2015,10,DAL,NOP,W ,102,93,240,38,79,0.481,32,63,0.508,6,16,0.375,20,22,0.909,35,74,0.473,25,53,0.472,10,21,0.476,13,16,0.813
3/2/2015,1,MIA,PHO,W ,115,98,240,43,82,0.524,36,68,0.529,7,14,0.5,22,30,0.733,33,78,0.423,26,47,0.553,7,31,0.226,25,38,0.658
3/2/2015,9,MIN,LAC,L ,105,110,240,36,82,0.439,32,67,0.478,4,15,0.267,29,35,0.829,44,92,0.478,32,59,0.542,12,33,0.364,10,19,0.526
3/2/2015,4,PHI,TOR,L ,103,114,240,41,78,0.526,33,58,0.569,8,20,0.4,13,19,0.684,41,80,0.513,30,53,0.566,11,27,0.407,21,24,0.875
3/1/2015,6,BOS,GSW,L ,101,106,240,40,109,0.367,32,78,0.41,8,31,0.258,13,17,0.765,40,95,0.421,28,61,0.459,12,34,0.353,14,17,0.824
3/1/2015,14,CHI,LAC,L ,86,96,240,27,87,0.31,17,61,0.279,10,26,0.385,22,30,0.733,38,87,0.437,31,60,0.517,7,27,0.259,13,24,0.542
3/1/2015,9,DEN,NOP,L ,92,99,240,37,92,0.402,28,59,0.475,9,33,0.273,9,17,0.529,36,74,0.486,31,52,0.596,5,22,0.227,22,30,0.733
3/1/2015,11,HOU,CLE,W ,105,103,265,34,74,0.459,23,44,0.523,11,30,0.367,26,33,0.788,40,98,0.408,28,58,0.483,12,40,0.3,11,21,0.524
3/1/2015,2,IND,PHI,W ,94,74,240,36,88,0.409,33,70,0.471,3,18,0.167,19,25,0.76,29,84,0.345,24,60,0.4,5,24,0.208,11,17,0.647
3/1/2015,0,LAL,OKC,L ,101,108,240,40,90,0.444,31,65,0.477,9,25,0.36,12,18,0.667,40,97,0.412,29,65,0.446,11,32,0.344,17,23,0.739
3/1/2015,4,ORL,CHO,L ,83,98,240,31,85,0.365,25,70,0.357,6,15,0.4,15,20,0.75,40,80,0.5,32,62,0.516,8,18,0.444,10,14,0.714
3/1/2015,5,SAC,POR,L ,99,110,240,39,86,0.453,36,74,0.486,3,12,0.25,18,23,0.783,41,83,0.494,31,59,0.525,10,24,0.417,18,20,0.9
2/28/2015,9,DAL,BRK,L ,94,104,240,35,82,0.427,26,54,0.481,9,28,0.321,15,18,0.833,40,77,0.519,30,54,0.556,10,23,0.435,14,23,0.609
2/28/2015,0,MIA,ATL,L ,91,93,240,32,81,0.395,25,55,0.455,7,26,0.269,20,21,0.952,34,79,0.43,24,54,0.444,10,25,0.4,15,20,0.75
2/28/2015,15,MIN,MEM,L ,97,101,240,34,88,0.386,27,69,0.391,7,19,0.368,22,27,0.815,38,64,0.594,34,53,0.642,4,11,0.364,21,29,0.724
2/28/2015,9,NYK,TOR,W ,103,98,240,33,75,0.44,26,56,0.464,7,19,0.368,30,38,0.789,34,81,0.42,26,52,0.5,8,29,0.276,22,28,0.786
2/28/2015,0,PHO,SAS,L ,74,101,240,25,84,0.298,20,68,0.294,5,16,0.313,19,24,0.792,41,92,0.446,37,73,0.507,4,19,0.211,15,17,0.882
2/28/2015,4,UTA,MIL,W ,82,75,240,29,76,0.382,23,54,0.426,6,22,0.273,18,23,0.783,29,74,0.392,24,59,0.407,5,15,0.333,12,14,0.857
2/28/2015,6,WAS,DET,W ,99,95,240,37,78,0.474,30,58,0.517,7,20,0.35,18,25,0.72,38,79,0.481,30,53,0.566,8,26,0.308,11,21,0.524
2/27/2015,7,ATL,ORL,W ,95,88,240,36,81,0.444,22,50,0.44,14,31,0.452,9,12,0.75,36,80,0.45,27,54,0.5,9,26,0.346,7,13,0.538
2/27/2015,2,BOS,CHO,W ,106,98,240,40,96,0.417,26,61,0.426,14,35,0.4,12,15,0.8,37,82,0.451,27,61,0.443,10,21,0.476,14,17,0.824
2/27/2015,6,CHI,MIN,W ,96,89,240,37,96,0.385,28,65,0.431,9,31,0.29,13,16,0.813,33,77,0.429,31,63,0.492,2,14,0.143,21,31,0.677
2/27/2015,1,DEN,UTA,L ,82,104,240,28,84,0.333,20,52,0.385,8,32,0.25,18,29,0.621,39,68,0.574,30,47,0.638,9,21,0.429,17,21,0.81
2/27/2015,14,DET,NYK,L ,115,121,290,39,97,0.402,31,66,0.47,8,31,0.258,29,40,0.725,45,109,0.413,39,91,0.429,6,18,0.333,25,26,0.962
2/27/2015,13,HOU,BRK,W ,102,98,240,39,84,0.464,30,52,0.577,9,32,0.281,15,17,0.882,38,85,0.447,34,68,0.5,4,17,0.235,18,20,0.9
2/27/2015,3,IND,CLE,W ,93,86,240,34,80,0.425,28,63,0.444,6,17,0.353,19,29,0.655,33,92,0.359,24,63,0.381,9,29,0.31,11,14,0.786
2/27/2015,2,LAL,MIL,W ,101,93,240,40,85,0.471,34,67,0.507,6,18,0.333,15,22,0.682,34,87,0.391,30,70,0.429,4,17,0.235,21,29,0.724
2/27/2015,6,MEM,LAC,L ,79,97,240,33,87,0.379,30,75,0.4,3,12,0.25,10,15,0.667,36,78,0.462,27,52,0.519,9,26,0.346,16,28,0.571
2/27/2015,19,NOP,MIA,W ,104,102,240,39,76,0.513,33,60,0.55,6,16,0.375,20,27,0.741,41,84,0.488,33,63,0.524,8,21,0.381,12,16,0.75
2/27/2015,12,PHI,WAS,W ,89,81,240,28,80,0.35,16,47,0.34,12,33,0.364,21,34,0.618,30,93,0.323,26,76,0.342,4,17,0.235,17,22,0.773
2/27/2015,2,POR,OKC,W ,115,112,240,39,89,0.438,29,63,0.46,10,26,0.385,27,31,0.871,45,94,0.479,41,80,0.513,4,14,0.286,18,22,0.818
2/27/2015,5,SAC,SAS,L ,96,107,240,38,79,0.481,37,75,0.493,1,4,0.25,19,23,0.826,35,88,0.398,27,65,0.415,8,23,0.348,29,32,0.906
2/27/2015,0,TOR,GSW,L ,89,113,240,31,77,0.403,27,55,0.491,4,22,0.182,23,28,0.821,42,87,0.483,29,59,0.492,13,28,0.464,16,19,0.842
2/26/2015,12,CLE,GSW,W ,110,99,240,36,77,0.468,27,49,0.551,9,28,0.321,29,35,0.829,39,92,0.424,28,63,0.444,11,29,0.379,10,19,0.526
2/26/2015,6,PHO,OKC,W ,117,113,265,48,97,0.495,39,71,0.549,9,26,0.346,12,21,0.571,39,101,0.386,31,77,0.403,8,24,0.333,27,30,0.9
2/25/2015,2,ATL,DAL,W ,104,87,240,39,85,0.459,26,50,0.52,13,35,0.371,13,16,0.813,34,80,0.425,29,49,0.592,5,31,0.161,14,18,0.778
2/25/2015,19,BOS,NYK,W ,115,94,240,42,83,0.506,28,52,0.538,14,31,0.452,17,20,0.85,34,82,0.415,32,61,0.525,2,21,0.095,24,31,0.774
2/25/2015,18,CHI,CHO,L ,86,98,240,34,77,0.442,31,60,0.517,3,17,0.176,15,23,0.652,39,84,0.464,35,70,0.5,4,14,0.286,16,21,0.762
2/25/2015,5,DEN,PHO,L ,96,110,240,31,81,0.383,19,47,0.404,12,34,0.353,22,33,0.667,39,91,0.429,31,67,0.463,8,24,0.333,24,32,0.75
2/25/2015,15,HOU,LAC,W ,110,105,240,36,88,0.409,19,44,0.432,17,44,0.386,21,30,0.7,40,91,0.44,29,59,0.492,11,32,0.344,14,19,0.737
2/25/2015,0,MIL,PHI,W ,104,88,240,44,82,0.537,39,67,0.582,5,15,0.333,11,16,0.688,31,75,0.413,20,50,0.4,11,25,0.44,15,19,0.789
2/25/2015,3,MIN,WAS,W ,97,77,240,35,81,0.432,31,68,0.456,4,13,0.308,23,28,0.821,33,87,0.379,29,69,0.42,4,18,0.222,7,8,0.875
2/25/2015,8,NOP,BRK,W ,102,96,240,38,74,0.514,27,49,0.551,11,25,0.44,15,19,0.789,39,92,0.424,32,71,0.451,7,21,0.333,11,15,0.733
2/25/2015,6,ORL,MIA,L ,90,93,265,33,78,0.423,27,56,0.482,6,22,0.273,18,31,0.581,32,84,0.381,26,53,0.491,6,31,0.194,23,32,0.719
2/25/2015,2,POR,SAS,W ,111,95,240,43,85,0.506,30,59,0.508,13,26,0.5,12,15,0.8,37,85,0.435,29,64,0.453,8,21,0.381,13,14,0.929
2/25/2015,10,SAC,MEM,W ,102,90,240,39,80,0.488,33,64,0.516,6,16,0.375,18,25,0.72,34,84,0.405,30,68,0.441,4,16,0.25,18,23,0.783
2/25/2015,1,UTA,LAL,L ,97,100,240,34,73,0.466,27,61,0.443,7,12,0.583,22,34,0.647,40,89,0.449,38,78,0.487,2,11,0.182,18,21,0.857
2/24/2015,6,DAL,TOR,W ,99,92,240,38,79,0.481,30,60,0.5,8,19,0.421,15,18,0.833,38,84,0.452,29,58,0.5,9,26,0.346,7,11,0.636
2/24/2015,7,DET,CLE,L ,93,102,240,33,82,0.402,24,58,0.414,9,24,0.375,18,30,0.6,34,77,0.442,20,40,0.5,14,37,0.378,20,24,0.833
2/24/2015,0,OKC,IND,W ,105,92,240,40,96,0.417,31,72,0.431,9,24,0.375,16,18,0.889,38,88,0.432,29,62,0.468,9,26,0.346,7,11,0.636
2/24/2015,7,WAS,GSW,L ,107,114,240,42,79,0.532,37,61,0.607,5,18,0.278,18,21,0.857,45,90,0.5,33,67,0.493,12,23,0.522,12,17,0.706
2/23/2015,1,CHI,MIL,W ,87,71,240,27,76,0.355,19,50,0.38,8,26,0.308,25,32,0.781,30,89,0.337,26,71,0.366,4,18,0.222,7,13,0.538
2/23/2015,6,DEN,BRK,L ,82,110,240,31,94,0.33,24,67,0.358,7,27,0.259,13,22,0.591,43,92,0.467,39,71,0.549,4,21,0.19,20,23,0.87
2/23/2015,11,HOU,MIN,W ,113,102,240,39,94,0.415,27,56,0.482,12,38,0.316,23,34,0.676,31,93,0.333,26,75,0.347,5,18,0.278,35,39,0.897
2/23/2015,12,LAC,MEM,L ,87,90,240,35,79,0.443,26,52,0.5,9,27,0.333,8,12,0.667,33,81,0.407,28,66,0.424,5,15,0.333,19,26,0.731
2/23/2015,18,MIA,PHI,W ,119,108,240,46,83,0.554,35,62,0.565,11,21,0.524,16,22,0.727,40,84,0.476,27,53,0.509,13,31,0.419,15,28,0.536
2/23/2015,3,NOP,TOR,W ,100,97,240,40,78,0.513,30,56,0.536,10,22,0.455,10,16,0.625,35,84,0.417,30,61,0.492,5,23,0.217,22,31,0.71
2/23/2015,1,PHO,BOS,L ,110,115,240,44,97,0.454,35,65,0.538,9,32,0.281,13,16,0.813,39,89,0.438,25,60,0.417,14,29,0.483,23,30,0.767
2/23/2015,3,UTA,SAS,W ,90,81,240,34,83,0.41,30,68,0.441,4,15,0.267,18,23,0.783,32,79,0.405,27,60,0.45,5,19,0.263,12,21,0.571
2/22/2015,1,DAL,CHO,W ,92,81,240,36,78,0.462,31,60,0.517,5,18,0.278,15,19,0.789,33,90,0.367,27,71,0.38,6,19,0.316,9,13,0.692
2/22/2015,12,DET,WAS,W ,106,89,240,37,89,0.416,24,57,0.421,13,32,0.406,19,25,0.76,37,85,0.435,31,68,0.456,6,17,0.353,9,14,0.643
2/22/2015,9,IND,GSW,W ,104,98,240,39,81,0.481,31,62,0.5,8,19,0.421,18,23,0.783,34,89,0.382,25,63,0.397,9,26,0.346,21,22,0.955
2/22/2015,3,LAL,BOS,W ,118,111,265,43,84,0.512,36,66,0.545,7,18,0.389,25,38,0.658,42,98,0.429,34,65,0.523,8,33,0.242,19,27,0.704
2/22/2015,1,MIL,ATL,L ,86,97,240,32,72,0.444,28,56,0.5,4,16,0.25,18,18,1,35,87,0.402,26,57,0.456,9,30,0.3,18,21,0.857
2/22/2015,0,NYK,CLE,L ,83,101,240,37,99,0.374,34,80,0.425,3,19,0.158,6,7,0.857,40,79,0.506,28,46,0.609,12,33,0.364,9,15,0.6
2/22/2015,6,OKC,DEN,W ,119,94,240,48,92,0.522,40,72,0.556,8,20,0.4,15,23,0.652,35,97,0.361,28,70,0.4,7,27,0.259,17,20,0.85
2/22/2015,9,ORL,PHI,W ,103,98,240,39,82,0.476,33,59,0.559,6,23,0.261,19,26,0.731,36,78,0.462,23,44,0.523,13,34,0.382,13,17,0.765
2/22/2015,13,POR,MEM,L ,92,98,240,33,82,0.402,20,49,0.408,13,33,0.394,13,16,0.813,42,89,0.472,39,80,0.488,3,9,0.333,11,13,0.846
2/21/2015,9,CHI,PHO,W ,112,107,240,43,89,0.483,31,65,0.477,12,24,0.5,14,16,0.875,47,88,0.534,37,63,0.587,10,25,0.4,3,8,0.375
2/21/2015,12,CHO,OKC,L ,103,110,240,40,93,0.43,33,69,0.478,7,24,0.292,16,20,0.8,42,95,0.442,37,77,0.481,5,18,0.278,21,26,0.808
2/21/2015,6,HOU,TOR,W ,98,76,240,35,84,0.417,29,55,0.527,6,29,0.207,22,31,0.71,25,77,0.325,21,59,0.356,4,18,0.222,22,28,0.786
2/21/2015,6,LAC,SAC,W ,126,99,240,46,95,0.484,32,60,0.533,14,35,0.4,20,28,0.714,30,88,0.341,26,72,0.361,4,16,0.25,35,46,0.761
2/21/2015,0,MIA,NOP,L ,91,105,240,33,79,0.418,28,62,0.452,5,17,0.294,20,27,0.741,35,83,0.422,27,62,0.435,8,21,0.381,27,31,0.871
2/20/2015,8,ATL,TOR,L ,80,105,240,29,88,0.33,21,50,0.42,8,38,0.211,14,21,0.667,43,96,0.448,30,66,0.455,13,30,0.433,6,8,0.75
2/20/2015,1,DAL,HOU,W ,111,100,240,44,93,0.473,35,69,0.507,9,24,0.375,14,18,0.778,36,87,0.414,24,50,0.48,12,37,0.324,16,26,0.615
2/20/2015,11,DET,CHI,W ,100,91,240,38,84,0.452,32,62,0.516,6,22,0.273,18,33,0.545,33,78,0.423,28,62,0.452,5,16,0.313,20,22,0.909
2/20/2015,16,GSW,SAS,W ,110,99,240,41,84,0.488,24,51,0.471,17,33,0.515,11,18,0.611,39,81,0.481,33,62,0.532,6,19,0.316,15,20,0.75
2/20/2015,11,LAL,BRK,L ,105,114,240,41,89,0.461,37,66,0.561,4,23,0.174,19,29,0.655,42,89,0.472,32,68,0.471,10,21,0.476,20,24,0.833
2/20/2015,1,MIL,DEN,W ,89,81,240,33,78,0.423,28,63,0.444,5,15,0.333,18,22,0.818,30,84,0.357,23,58,0.397,7,26,0.269,14,21,0.667
2/20/2015,15,MIN,PHO,W ,111,109,240,40,86,0.465,36,71,0.507,4,15,0.267,27,38,0.711,40,89,0.449,33,72,0.458,7,17,0.412,22,31,0.71
2/20/2015,9,NYK,MIA,L ,87,111,240,35,82,0.427,29,64,0.453,6,18,0.333,11,16,0.688,38,79,0.481,29,59,0.492,9,20,0.45,26,35,0.743
2/20/2015,10,ORL,NOP,W ,95,84,240,44,88,0.5,40,70,0.571,4,18,0.222,3,6,0.5,29,69,0.42,24,50,0.48,5,19,0.263,21,28,0.75
2/20/2015,2,PHI,IND,L ,95,106,240,34,84,0.405,26,59,0.441,8,25,0.32,19,29,0.655,40,83,0.482,32,61,0.525,8,22,0.364,18,22,0.818
2/20/2015,3,SAC,BOS,W ,109,101,240,40,83,0.482,32,61,0.525,8,22,0.364,21,26,0.808,40,100,0.4,34,78,0.436,6,22,0.273,15,26,0.577
2/20/2015,9,UTA,POR,W ,92,76,240,37,83,0.446,27,58,0.466,10,25,0.4,8,17,0.471,26,72,0.361,22,50,0.44,4,22,0.182,20,22,0.909
2/20/2015,1,WAS,CLE,L ,89,127,240,38,86,0.442,37,70,0.529,1,16,0.063,12,16,0.75,46,90,0.511,32,57,0.561,14,33,0.424,21,28,0.75
2/19/2015,20,LAC,SAS,W ,119,115,240,42,77,0.545,34,58,0.586,8,19,0.421,27,52,0.519,43,84,0.512,33,56,0.589,10,28,0.357,19,23,0.826
2/19/2015,0,OKC,DAL,W ,104,89,240,38,91,0.418,31,69,0.449,7,22,0.318,21,26,0.808,33,91,0.363,24,64,0.375,9,27,0.333,14,17,0.824
2/12/2015,1,CHI,CLE,W ,113,98,240,42,92,0.457,33,69,0.478,9,23,0.391,20,26,0.769,37,85,0.435,29,54,0.537,8,31,0.258,16,22,0.727
2/11/2015,1,BOS,ATL,W ,89,88,240,30,93,0.323,20,62,0.323,10,31,0.323,19,20,0.95,33,78,0.423,26,49,0.531,7,29,0.241,15,23,0.652
2/11/2015,5,CLE,MIA,W ,113,93,240,44,78,0.564,34,53,0.642,10,25,0.4,15,19,0.789,34,84,0.405,25,60,0.417,9,24,0.375,16,20,0.8
2/11/2015,9,DAL,UTA,W ,87,82,240,28,75,0.373,18,47,0.383,10,28,0.357,21,26,0.808,30,80,0.375,19,51,0.373,11,29,0.379,11,21,0.524
2/11/2015,1,DET,SAS,L ,87,104,240,33,81,0.407,24,60,0.4,9,21,0.429,12,17,0.706,42,88,0.477,32,61,0.525,10,27,0.37,10,11,0.909
2/11/2015,14,LAC,HOU,W ,110,95,240,39,81,0.481,35,59,0.593,4,22,0.182,28,45,0.622,34,87,0.391,25,42,0.595,9,45,0.2,18,22,0.818
2/11/2015,6,MIL,SAC,W ,111,103,240,39,80,0.488,32,65,0.492,7,15,0.467,26,32,0.813,36,84,0.429,28,62,0.452,8,22,0.364,23,30,0.767
2/11/2015,7,MIN,GSW,L ,91,94,240,33,86,0.384,28,72,0.389,5,14,0.357,20,27,0.741,40,90,0.444,33,63,0.524,7,27,0.259,7,9,0.778
2/11/2015,0,NOP,IND,L ,93,106,240,34,74,0.459,27,59,0.458,7,15,0.467,18,25,0.72,40,75,0.533,31,55,0.564,9,20,0.45,17,18,0.944
2/11/2015,0,OKC,MEM,W ,105,89,240,37,83,0.446,30,63,0.476,7,20,0.35,24,25,0.96,32,86,0.372,30,74,0.405,2,12,0.167,23,30,0.767
2/11/2015,21,ORL,NYK,W ,89,83,240,31,67,0.463,27,56,0.482,4,11,0.364,23,28,0.821,25,73,0.342,20,58,0.345,5,15,0.333,28,36,0.778
2/11/2015,0,POR,LAL,W ,102,86,240,35,86,0.407,25,56,0.446,10,30,0.333,22,23,0.957,34,93,0.366,27,77,0.351,7,16,0.438,11,11,1
2/11/2015,14,TOR,WAS,W ,95,93,240,31,76,0.408,20,50,0.4,11,26,0.423,22,26,0.846,39,85,0.459,34,64,0.531,5,21,0.238,10,16,0.625
2/10/2015,5,CHI,SAC,W ,104,86,240,42,80,0.525,35,60,0.583,7,20,0.35,13,15,0.867,35,75,0.467,33,63,0.524,2,12,0.167,14,27,0.519
2/10/2015,11,CHO,DET,L ,78,106,240,29,81,0.358,20,57,0.351,9,24,0.375,11,14,0.786,37,83,0.446,32,64,0.5,5,19,0.263,27,30,0.9
2/10/2015,7,LAL,DEN,L ,96,106,240,37,85,0.435,31,67,0.463,6,18,0.333,16,27,0.593,43,79,0.544,39,63,0.619,4,16,0.25,16,23,0.696
2/10/2015,2,MEM,BRK,W ,95,86,240,36,81,0.444,30,62,0.484,6,19,0.316,17,25,0.68,35,81,0.432,32,69,0.464,3,12,0.25,13,17,0.765
2/10/2015,6,PHO,HOU,L ,118,127,240,41,87,0.471,29,61,0.475,12,26,0.462,24,30,0.8,48,95,0.505,33,58,0.569,15,37,0.405,16,23,0.696
2/9/2015,7,DAL,LAC,L ,98,115,240,33,81,0.407,23,47,0.489,10,34,0.294,22,30,0.733,41,92,0.446,32,65,0.492,9,27,0.333,24,29,0.828
2/9/2015,0,DEN,OKC,L ,114,124,240,42,87,0.483,33,59,0.559,9,28,0.321,21,29,0.724,43,80,0.538,31,56,0.554,12,24,0.5,26,35,0.743
2/9/2015,8,IND,SAS,L ,93,95,240,36,88,0.409,28,67,0.418,8,21,0.381,13,13,1,37,89,0.416,31,64,0.484,6,25,0.24,15,17,0.882
2/9/2015,7,MIA,NYK,W ,109,95,240,36,74,0.486,24,52,0.462,12,22,0.545,25,29,0.862,36,84,0.429,29,64,0.453,7,20,0.35,16,19,0.842
2/9/2015,3,MIL,BRK,W ,103,97,240,37,89,0.416,30,71,0.423,7,18,0.389,22,25,0.88,38,76,0.5,29,51,0.569,9,25,0.36,12,19,0.632
2/9/2015,9,MIN,ATL,L ,105,117,240,42,93,0.452,37,77,0.481,5,16,0.313,16,22,0.727,44,86,0.512,34,65,0.523,10,21,0.476,19,20,0.95
2/9/2015,10,NOP,UTA,L ,96,100,240,33,79,0.418,20,57,0.351,13,22,0.591,17,20,0.85,39,93,0.419,30,72,0.417,9,21,0.429,13,19,0.684
2/9/2015,3,PHI,GSW,L ,84,89,240,33,79,0.418,26,55,0.473,7,24,0.292,11,14,0.786,34,85,0.4,27,56,0.482,7,29,0.241,14,19,0.737
2/9/2015,0,WAS,ORL,W ,96,80,240,33,77,0.429,26,52,0.5,7,25,0.28,23,27,0.852,33,83,0.398,29,61,0.475,4,22,0.182,10,15,0.667
2/8/2015,4,CHO,IND,L ,102,103,240,36,77,0.468,28,63,0.444,8,14,0.571,22,28,0.786,37,84,0.44,30,65,0.462,7,19,0.368,22,25,0.88
2/8/2015,12,CLE,LAL,W ,120,105,240,45,82,0.549,27,49,0.551,18,33,0.545,12,20,0.6,41,100,0.41,34,77,0.442,7,23,0.304,16,19,0.842
2/8/2015,0,DET,MIN,L ,101,112,240,37,79,0.468,27,48,0.563,10,31,0.323,17,22,0.773,39,76,0.513,34,64,0.531,5,12,0.417,29,34,0.853
2/8/2015,6,HOU,POR,L ,98,109,240,31,82,0.378,18,47,0.383,13,35,0.371,23,34,0.676,40,76,0.526,31,47,0.66,9,29,0.31,20,23,0.87
2/8/2015,19,MEM,ATL,W ,94,88,240,36,92,0.391,33,79,0.418,3,13,0.231,19,21,0.905,33,80,0.413,21,50,0.42,12,30,0.4,10,11,0.909
2/8/2015,10,OKC,LAC,W ,131,108,240,46,88,0.523,38,68,0.559,8,20,0.4,31,38,0.816,42,90,0.467,30,58,0.517,12,32,0.375,12,17,0.706
2/8/2015,12,ORL,CHI,L ,97,98,240,39,83,0.47,30,58,0.517,9,25,0.36,10,13,0.769,37,77,0.481,29,55,0.527,8,22,0.364,16,18,0.889
2/8/2015,4,SAC,PHO,W ,85,83,240,34,75,0.453,30,63,0.476,4,12,0.333,13,21,0.619,33,91,0.363,28,63,0.444,5,28,0.179,12,17,0.706
2/8/2015,6,TOR,SAS,W ,87,82,240,32,74,0.432,28,61,0.459,4,13,0.308,19,24,0.792,31,93,0.333,24,65,0.369,7,28,0.25,13,16,0.813
2/7/2015,13,DAL,POR,W ,111,101,265,43,105,0.41,29,69,0.42,14,36,0.389,11,16,0.688,37,89,0.416,27,57,0.474,10,32,0.313,17,24,0.708
2/7/2015,13,MIL,BOS,W ,96,93,240,37,75,0.493,29,55,0.527,8,20,0.4,14,19,0.737,36,86,0.419,29,57,0.509,7,29,0.241,14,20,0.7
2/7/2015,10,NOP,CHI,L ,72,107,240,32,86,0.372,28,69,0.406,4,17,0.235,4,7,0.571,43,84,0.512,33,62,0.532,10,22,0.455,11,13,0.846
2/7/2015,2,NYK,GSW,L ,92,106,240,35,87,0.402,27,69,0.391,8,18,0.444,14,17,0.824,37,81,0.457,25,56,0.446,12,25,0.48,20,24,0.833
2/7/2015,9,PHI,CHO,W ,89,81,240,29,74,0.392,20,51,0.392,9,23,0.391,22,30,0.733,29,84,0.345,23,61,0.377,6,23,0.261,17,20,0.85
2/7/2015,0,UTA,SAC,W ,102,90,240,43,86,0.5,38,67,0.567,5,19,0.263,11,17,0.647,32,82,0.39,29,69,0.42,3,13,0.231,23,33,0.697
2/7/2015,0,WAS,BRK,W ,114,77,240,44,87,0.506,35,67,0.522,9,20,0.45,17,23,0.739,26,77,0.338,22,59,0.373,4,18,0.222,21,31,0.677
2/6/2015,4,ATL,GSW,W ,124,116,240,38,77,0.494,23,50,0.46,15,27,0.556,33,37,0.892,47,103,0.456,35,70,0.5,12,33,0.364,10,15,0.667
2/6/2015,0,BOS,PHI,W ,107,96,240,39,86,0.453,29,59,0.492,10,27,0.37,19,25,0.76,35,79,0.443,24,54,0.444,11,25,0.44,15,31,0.484
2/6/2015,6,BRK,NYK,W ,92,88,240,37,74,0.5,34,63,0.54,3,11,0.273,15,22,0.682,34,89,0.382,28,65,0.431,6,24,0.25,14,17,0.824
2/6/2015,3,DET,DEN,W ,98,88,240,37,82,0.451,33,58,0.569,4,24,0.167,20,26,0.769,33,85,0.388,28,63,0.444,5,22,0.227,17,22,0.773
2/6/2015,1,HOU,MIL,W ,117,111,240,41,81,0.506,26,49,0.531,15,32,0.469,20,29,0.69,48,95,0.505,44,78,0.564,4,17,0.235,11,15,0.733
2/6/2015,7,IND,CLE,W ,103,99,240,37,79,0.468,29,58,0.5,8,21,0.381,21,26,0.808,40,89,0.449,29,54,0.537,11,35,0.314,8,12,0.667
2/6/2015,6,MIN,MEM,W ,90,89,240,35,81,0.432,30,64,0.469,5,17,0.294,15,17,0.882,36,69,0.522,34,57,0.596,2,12,0.167,15,20,0.75
2/6/2015,4,OKC,NOP,L ,113,116,240,40,89,0.449,32,65,0.492,8,24,0.333,25,28,0.893,40,83,0.482,29,63,0.46,11,20,0.55,25,30,0.833
2/6/2015,9,ORL,LAL,W ,103,97,265,43,83,0.518,38,68,0.559,5,15,0.333,12,14,0.857,39,97,0.402,28,71,0.394,11,26,0.423,8,13,0.615
2/6/2015,5,PHO,UTA,W ,100,93,240,38,84,0.452,24,57,0.421,14,27,0.519,10,14,0.714,37,80,0.463,30,60,0.5,7,20,0.35,12,18,0.667
2/6/2015,1,SAS,MIA,W ,98,85,240,40,83,0.482,29,54,0.537,11,29,0.379,7,9,0.778,36,80,0.45,31,64,0.484,5,16,0.313,8,9,0.889
2/6/2015,1,TOR,LAC,W ,123,107,240,40,75,0.533,27,45,0.6,13,30,0.433,30,37,0.811,38,78,0.487,32,55,0.582,6,23,0.261,25,31,0.806
2/5/2015,11,CHO,WAS,W ,94,87,240,33,76,0.434,27,51,0.529,6,25,0.24,22,27,0.815,35,84,0.417,30,74,0.405,5,10,0.5,12,17,0.706
2/5/2015,1,CLE,LAC,W ,105,94,240,31,72,0.431,23,42,0.548,8,30,0.267,35,44,0.795,38,91,0.418,33,69,0.478,5,22,0.227,13,20,0.65
2/5/2015,6,POR,PHO,W ,108,87,240,40,90,0.444,32,59,0.542,8,31,0.258,20,23,0.87,34,88,0.386,28,65,0.431,6,23,0.261,13,17,0.765
2/5/2015,7,SAC,DAL,L ,78,101,240,29,79,0.367,26,58,0.448,3,21,0.143,17,22,0.773,41,96,0.427,29,62,0.468,12,34,0.353,7,10,0.7
2/4/2015,7,ATL,WAS,W ,105,96,240,38,80,0.475,27,55,0.491,11,25,0.44,18,27,0.667,34,77,0.442,30,61,0.492,4,16,0.25,24,30,0.8
2/4/2015,8,BOS,DEN,W ,104,100,240,40,99,0.404,28,71,0.394,12,28,0.429,12,17,0.706,33,80,0.413,29,56,0.518,4,24,0.167,30,33,0.909
2/4/2015,1,GSW,DAL,W ,128,114,240,45,86,0.523,26,48,0.542,19,38,0.5,19,25,0.76,41,98,0.418,31,68,0.456,10,30,0.333,22,28,0.786
2/4/2015,10,HOU,CHI,W ,101,90,240,38,92,0.413,30,65,0.462,8,27,0.296,17,23,0.739,31,89,0.348,23,64,0.359,8,25,0.32,20,26,0.769
2/4/2015,6,IND,DET,W ,114,109,240,46,77,0.597,34,56,0.607,12,21,0.571,10,18,0.556,43,87,0.494,31,63,0.492,12,24,0.5,11,15,0.733
2/4/2015,6,MIL,LAL,W ,113,105,265,41,82,0.5,30,56,0.536,11,26,0.423,20,22,0.909,39,93,0.419,30,65,0.462,9,28,0.321,18,25,0.72
2/4/2015,4,MIN,MIA,W ,102,101,240,37,72,0.514,31,61,0.508,6,11,0.545,22,27,0.815,39,80,0.488,32,64,0.5,7,16,0.438,16,24,0.667
2/4/2015,20,NOP,OKC,L ,91,102,240,37,97,0.381,30,72,0.417,7,25,0.28,10,13,0.769,45,85,0.529,40,70,0.571,5,15,0.333,7,11,0.636
2/4/2015,4,SAS,ORL,W ,110,103,240,44,84,0.524,30,52,0.577,14,32,0.438,8,14,0.571,42,84,0.5,32,63,0.508,10,21,0.476,9,14,0.643
2/4/2015,13,TOR,BRK,L ,93,109,240,35,79,0.443,25,46,0.543,10,33,0.303,13,18,0.722,40,81,0.494,31,62,0.5,9,19,0.474,20,23,0.87
2/4/2015,1,UTA,MEM,L ,90,100,240,33,73,0.452,26,50,0.52,7,23,0.304,17,26,0.654,38,80,0.475,32,67,0.478,6,13,0.462,18,22,0.818
2/3/2015,2,DET,MIA,W ,108,91,240,42,88,0.477,33,68,0.485,9,20,0.45,15,18,0.833,35,74,0.473,29,60,0.483,6,14,0.429,15,23,0.652
2/3/2015,0,NYK,BOS,L ,97,108,240,41,83,0.494,34,63,0.54,7,20,0.35,8,11,0.727,42,77,0.545,36,53,0.679,6,24,0.25,18,23,0.783
2/3/2015,7,PHI,DEN,W ,105,98,240,31,70,0.443,20,43,0.465,11,27,0.407,32,42,0.762,33,85,0.388,21,54,0.389,12,31,0.387,20,28,0.714
2/3/2015,8,POR,UTA,W ,103,102,240,36,76,0.474,29,53,0.547,7,23,0.304,24,34,0.706,39,85,0.459,33,72,0.458,6,13,0.462,18,26,0.692
2/3/2015,1,SAC,GSW,L ,96,121,240,35,79,0.443,28,63,0.444,7,16,0.438,19,24,0.792,46,91,0.505,36,68,0.529,10,23,0.435,19,26,0.731
2/2/2015,10,BRK,LAC,W ,102,100,240,41,83,0.494,29,56,0.518,12,27,0.444,8,18,0.444,42,89,0.472,34,66,0.515,8,23,0.348,8,25,0.32
2/2/2015,0,CLE,PHI,W ,97,84,240,35,78,0.449,23,51,0.451,12,27,0.444,15,22,0.682,31,78,0.397,19,45,0.422,12,33,0.364,10,14,0.714
2/2/2015,0,DAL,MIN,W ,100,94,240,39,84,0.464,29,53,0.547,10,31,0.323,12,18,0.667,34,82,0.415,31,69,0.449,3,13,0.231,23,26,0.885
2/2/2015,3,NOP,ATL,W ,115,100,240,43,86,0.5,34,63,0.54,9,23,0.391,20,23,0.87,40,89,0.449,33,67,0.493,7,22,0.318,13,17,0.765
2/2/2015,4,OKC,ORL,W ,104,97,240,37,75,0.493,29,55,0.527,8,20,0.4,22,26,0.846,38,90,0.422,32,67,0.478,6,23,0.261,15,18,0.833
2/2/2015,7,PHO,MEM,L ,101,102,240,42,84,0.5,36,68,0.529,6,16,0.375,11,18,0.611,36,83,0.434,33,72,0.458,3,11,0.273,27,34,0.794
2/2/2015,0,TOR,MIL,L ,75,82,240,25,78,0.321,18,51,0.353,7,27,0.259,18,22,0.818,33,80,0.413,26,64,0.406,7,16,0.438,9,17,0.529
2/2/2015,6,WAS,CHO,L ,88,92,240,33,81,0.407,27,66,0.409,6,15,0.4,16,19,0.842,37,79,0.468,33,64,0.516,4,15,0.267,14,19,0.737
2/1/2015,0,BOS,MIA,L ,75,83,240,30,81,0.37,26,62,0.419,4,19,0.211,11,18,0.611,32,77,0.416,28,56,0.5,4,21,0.19,15,21,0.714
2/1/2015,0,NYK,LAL,W ,92,80,240,37,84,0.44,27,62,0.435,10,22,0.455,8,13,0.615,27,76,0.355,20,60,0.333,7,16,0.438,19,23,0.826
1/31/2015,2,ATL,PHI,W ,91,85,240,34,78,0.436,24,50,0.48,10,28,0.357,13,18,0.722,31,81,0.383,17,46,0.37,14,35,0.4,9,15,0.6
1/31/2015,5,DEN,CHO,L ,86,104,240,33,92,0.359,28,68,0.412,5,24,0.208,15,20,0.75,44,93,0.473,44,82,0.537,0,11,0,16,25,0.64
1/31/2015,3,DET,HOU,W ,114,101,240,41,82,0.5,31,57,0.544,10,25,0.4,22,35,0.629,39,87,0.448,28,55,0.509,11,32,0.344,12,19,0.632
1/31/2015,3,GSW,PHO,W ,106,87,240,40,87,0.46,28,55,0.509,12,32,0.375,14,18,0.778,33,91,0.363,24,65,0.369,9,26,0.346,12,17,0.706
1/31/2015,3,IND,SAC,L ,94,99,240,33,80,0.413,28,55,0.509,5,25,0.2,23,25,0.92,34,80,0.425,29,65,0.446,5,15,0.333,26,29,0.897
1/31/2015,10,MEM,OKC,W ,85,74,240,34,91,0.374,31,80,0.388,3,11,0.273,14,17,0.824,27,78,0.346,21,58,0.362,6,20,0.3,14,18,0.778
1/31/2015,3,MIL,POR,W ,95,88,240,37,82,0.451,29,61,0.475,8,21,0.381,13,14,0.929,33,89,0.371,24,58,0.414,9,31,0.29,13,18,0.722
1/31/2015,3,MIN,CLE,L ,90,106,240,34,82,0.415,28,69,0.406,6,13,0.462,16,21,0.762,42,87,0.483,32,55,0.582,10,32,0.313,12,19,0.632
1/31/2015,1,ORL,DAL,L ,93,108,240,33,78,0.423,25,54,0.463,8,24,0.333,19,24,0.792,42,74,0.568,31,53,0.585,11,21,0.524,13,22,0.591
1/31/2015,2,SAS,LAC,L ,85,105,240,28,75,0.373,18,45,0.4,10,30,0.333,19,28,0.679,40,91,0.44,32,69,0.464,8,22,0.364,17,18,0.944
1/31/2015,2,WAS,TOR,L ,116,120,265,37,79,0.468,27,55,0.491,10,24,0.417,32,41,0.78,44,88,0.5,33,62,0.532,11,26,0.423,21,30,0.7
1/30/2015,16,ATL,POR,W ,105,99,240,40,84,0.476,29,61,0.475,11,23,0.478,14,22,0.636,39,87,0.448,28,57,0.491,11,30,0.367,10,11,0.909
1/30/2015,1,BOS,HOU,L ,87,93,240,32,90,0.356,25,66,0.379,7,24,0.292,16,23,0.696,35,84,0.417,27,54,0.5,8,30,0.267,15,20,0.75
1/30/2015,12,BRK,TOR,L ,122,127,265,49,101,0.485,45,82,0.549,4,19,0.211,20,26,0.769,47,92,0.511,40,66,0.606,7,26,0.269,26,30,0.867
1/30/2015,2,CLE,SAC,W ,101,90,240,38,80,0.475,27,49,0.551,11,31,0.355,14,22,0.636,30,84,0.357,27,66,0.409,3,18,0.167,27,32,0.844
1/30/2015,1,MIA,DAL,L ,72,93,240,29,88,0.33,20,59,0.339,9,29,0.31,5,10,0.5,34,82,0.415,21,53,0.396,13,29,0.448,12,20,0.6
1/30/2015,13,NOP,LAC,W ,108,103,240,36,86,0.419,23,61,0.377,13,25,0.52,23,26,0.885,42,92,0.457,35,64,0.547,7,28,0.25,12,17,0.706
1/30/2015,19,PHI,MIN,W ,103,94,240,37,74,0.5,29,51,0.569,8,23,0.348,21,25,0.84,34,76,0.447,29,62,0.468,5,14,0.357,21,25,0.84
1/30/2015,8,PHO,CHI,W ,99,93,240,39,90,0.433,33,68,0.485,6,22,0.273,15,17,0.882,36,87,0.414,32,69,0.464,4,18,0.222,17,27,0.63
1/30/2015,0,UTA,GSW,W ,110,100,240,42,94,0.447,33,69,0.478,9,25,0.36,17,28,0.607,37,86,0.43,29,59,0.492,8,27,0.296,18,25,0.72
1/29/2015,1,IND,NYK,W ,103,82,240,42,79,0.532,36,61,0.59,6,18,0.333,13,18,0.722,34,81,0.42,29,65,0.446,5,16,0.313,9,13,0.692
1/29/2015,2,LAL,CHI,W ,123,118,290,50,106,0.472,47,97,0.485,3,9,0.333,20,25,0.8,43,104,0.413,37,79,0.468,6,25,0.24,26,32,0.813
1/29/2015,0,MEM,DEN,W ,99,69,240,39,88,0.443,36,72,0.5,3,16,0.188,18,27,0.667,29,87,0.333,27,61,0.443,2,26,0.077,9,10,0.9
1/29/2015,0,ORL,MIL,L ,100,115,240,37,82,0.451,32,64,0.5,5,18,0.278,21,30,0.7,45,87,0.517,33,62,0.532,12,25,0.48,13,18,0.722
1/28/2015,9,ATL,BRK,W ,113,102,240,38,82,0.463,26,49,0.531,12,33,0.364,25,26,0.962,39,87,0.448,30,63,0.476,9,24,0.375,15,18,0.833
1/28/2015,3,CLE,POR,W ,99,94,240,34,85,0.4,19,48,0.396,15,37,0.405,16,18,0.889,35,80,0.438,25,49,0.51,10,31,0.323,14,17,0.824
1/28/2015,5,HOU,DAL,W ,99,94,240,36,88,0.409,22,53,0.415,14,35,0.4,13,15,0.867,35,82,0.427,25,57,0.439,10,25,0.4,14,16,0.875
1/28/2015,5,MIN,BOS,W ,110,98,240,38,77,0.494,32,61,0.525,6,16,0.375,28,32,0.875,42,91,0.462,35,68,0.515,7,23,0.304,7,9,0.778
1/28/2015,12,NOP,DEN,L ,85,93,240,32,82,0.39,29,67,0.433,3,15,0.2,18,24,0.75,39,85,0.459,29,68,0.426,10,17,0.588,5,7,0.714
1/28/2015,18,NYK,OKC,W ,100,92,240,40,91,0.44,32,74,0.432,8,17,0.471,12,17,0.706,34,85,0.4,29,63,0.46,5,22,0.227,19,22,0.864
1/28/2015,1,PHI,DET,W ,89,69,240,37,78,0.474,30,57,0.526,7,21,0.333,8,12,0.667,23,75,0.307,21,55,0.382,2,20,0.1,21,23,0.913
1/28/2015,10,PHO,WAS,W ,106,98,240,40,88,0.455,29,59,0.492,11,29,0.379,15,18,0.833,37,88,0.42,29,70,0.414,8,18,0.444,16,23,0.696
1/28/2015,2,SAS,CHO,W ,95,86,240,35,83,0.422,25,54,0.463,10,29,0.345,15,18,0.833,34,83,0.41,28,65,0.431,6,18,0.333,12,14,0.857
1/28/2015,8,TOR,SAC,W ,119,102,240,43,84,0.512,26,50,0.52,17,34,0.5,16,19,0.842,35,73,0.479,28,56,0.5,7,17,0.412,25,29,0.862
1/28/2015,12,UTA,LAC,L ,89,94,240,35,81,0.432,30,57,0.526,5,24,0.208,14,20,0.7,34,76,0.447,25,50,0.5,9,26,0.346,17,25,0.68
1/27/2015,7,DAL,MEM,L ,90,109,240,38,78,0.487,31,52,0.596,7,26,0.269,7,10,0.7,42,79,0.532,32,58,0.552,10,21,0.476,15,20,0.75
1/27/2015,3,DET,CLE,L ,95,103,240,35,83,0.422,27,59,0.458,8,24,0.333,17,23,0.739,39,93,0.419,30,59,0.508,9,34,0.265,16,17,0.941
1/27/2015,4,GSW,CHI,L ,111,113,265,48,113,0.425,39,80,0.488,9,33,0.273,6,12,0.5,42,98,0.429,34,69,0.493,8,29,0.276,21,23,0.913
1/27/2015,3,IND,TOR,L ,91,104,240,34,82,0.415,27,64,0.422,7,18,0.389,16,23,0.696,34,73,0.466,25,47,0.532,9,26,0.346,27,34,0.794
1/27/2015,4,LAL,WAS,L ,92,98,240,37,87,0.425,32,67,0.478,5,20,0.25,13,16,0.813,38,78,0.487,34,62,0.548,4,16,0.25,18,27,0.667
1/27/2015,16,MIA,MIL,L ,102,109,240,38,75,0.507,31,55,0.564,7,20,0.35,19,26,0.731,39,71,0.549,30,55,0.545,9,16,0.563,22,30,0.733
1/26/2015,3,LAC,DEN,W ,102,98,240,38,80,0.475,31,61,0.508,7,19,0.368,19,22,0.864,40,83,0.482,32,62,0.516,8,21,0.381,10,15,0.667
1/26/2015,2,MEM,ORL,W ,103,94,240,36,76,0.474,29,58,0.5,7,18,0.389,24,26,0.923,37,78,0.474,33,66,0.5,4,12,0.333,16,25,0.64
1/26/2015,6,NOP,PHI,W ,99,74,240,39,86,0.453,32,70,0.457,7,16,0.438,14,19,0.737,28,81,0.346,26,66,0.394,2,15,0.133,16,21,0.762
1/26/2015,2,OKC,MIN,W ,92,84,240,36,86,0.419,32,66,0.485,4,20,0.2,16,24,0.667,29,85,0.341,27,72,0.375,2,13,0.154,24,32,0.75
1/26/2015,5,UTA,BOS,L ,90,99,240,35,82,0.427,26,58,0.448,9,24,0.375,11,19,0.579,35,74,0.473,27,55,0.491,8,19,0.421,21,23,0.913
1/25/2015,10,ATL,MIN,W ,112,100,240,45,80,0.563,35,52,0.673,10,28,0.357,12,18,0.667,37,71,0.521,31,55,0.564,6,16,0.375,20,25,0.8
1/25/2015,2,CHI,MIA,L ,84,96,240,31,87,0.356,24,63,0.381,7,24,0.292,15,19,0.789,38,84,0.452,37,71,0.521,1,13,0.077,19,23,0.826
1/25/2015,14,CLE,OKC,W ,108,98,240,36,82,0.439,20,46,0.435,16,36,0.444,20,29,0.69,37,94,0.394,27,64,0.422,10,30,0.333,14,18,0.778
1/25/2015,13,DEN,WAS,L ,115,117,265,41,101,0.406,29,72,0.403,12,29,0.414,21,28,0.75,48,90,0.533,44,76,0.579,4,14,0.286,17,23,0.739
1/25/2015,4,GSW,BOS,W ,114,111,240,42,89,0.472,34,66,0.515,8,23,0.348,22,25,0.88,41,95,0.432,31,67,0.463,10,28,0.357,19,27,0.704
1/25/2015,2,LAL,HOU,L ,87,99,240,34,79,0.43,33,66,0.5,1,13,0.077,18,25,0.72,35,87,0.402,22,43,0.512,13,44,0.295,16,21,0.762
1/25/2015,8,NOP,DAL,W ,109,106,240,40,79,0.506,32,62,0.516,8,17,0.471,21,25,0.84,39,81,0.481,30,57,0.526,9,24,0.375,19,25,0.76
1/25/2015,10,ORL,IND,L ,99,106,240,38,78,0.487,32,61,0.525,6,17,0.353,17,23,0.739,43,83,0.518,35,63,0.556,8,20,0.4,12,18,0.667
1/25/2015,11,PHO,LAC,L ,100,120,240,34,80,0.425,24,51,0.471,10,29,0.345,22,27,0.815,43,87,0.494,33,64,0.516,10,23,0.435,24,36,0.667
1/25/2015,3,SAS,MIL,W ,101,95,240,35,83,0.422,30,61,0.492,5,22,0.227,26,30,0.867,39,82,0.476,31,65,0.477,8,17,0.471,9,13,0.692
1/25/2015,11,TOR,DET,W ,114,110,240,43,81,0.531,38,66,0.576,5,15,0.333,23,29,0.793,41,90,0.456,29,56,0.518,12,34,0.353,16,23,0.696
1/24/2015,1,CHO,NYK,W ,76,71,240,25,76,0.329,23,69,0.333,2,7,0.286,24,37,0.649,28,79,0.354,22,64,0.344,6,15,0.4,9,18,0.5
1/24/2015,2,MEM,PHI,W ,101,83,240,37,79,0.468,31,65,0.477,6,14,0.429,21,25,0.84,31,81,0.383,22,57,0.386,9,24,0.375,12,22,0.545
1/24/2015,4,MIL,DET,W ,101,86,240,41,81,0.506,30,64,0.469,11,17,0.647,8,10,0.8,31,86,0.36,25,61,0.41,6,25,0.24,18,25,0.72
1/24/2015,5,POR,WAS,W ,103,96,240,35,87,0.402,22,56,0.393,13,31,0.419,20,20,1,40,82,0.488,35,67,0.522,5,15,0.333,11,14,0.786
1/24/2015,2,UTA,BRK,W ,108,73,240,42,79,0.532,29,50,0.58,13,29,0.448,11,14,0.786,29,75,0.387,24,60,0.4,5,15,0.333,10,16,0.625
1/23/2015,5,ATL,OKC,W ,103,93,240,40,83,0.482,30,58,0.517,10,25,0.4,13,13,1,36,87,0.414,26,61,0.426,10,26,0.385,11,18,0.611
1/23/2015,0,CLE,CHO,W ,129,90,240,46,89,0.517,31,61,0.508,15,28,0.536,22,28,0.786,36,89,0.404,34,73,0.466,2,16,0.125,16,24,0.667
1/23/2015,0,DAL,CHI,L ,98,102,240,37,82,0.451,31,64,0.484,6,18,0.333,18,18,1,38,78,0.487,29,62,0.468,9,16,0.563,17,20,0.85
1/23/2015,17,DEN,BOS,L ,99,100,240,37,89,0.416,31,68,0.456,6,21,0.286,19,26,0.731,37,75,0.493,28,54,0.519,9,21,0.429,17,27,0.63
1/23/2015,5,GSW,SAC,W ,126,101,240,45,94,0.479,28,54,0.519,17,40,0.425,19,22,0.864,34,82,0.415,30,65,0.462,4,17,0.235,29,34,0.853
1/23/2015,2,MIA,IND,W ,89,87,240,36,75,0.48,32,58,0.552,4,17,0.235,13,15,0.867,32,78,0.41,29,63,0.46,3,15,0.2,20,23,0.87
1/23/2015,3,MIN,NOP,L ,84,92,240,35,84,0.417,33,75,0.44,2,9,0.222,12,17,0.706,40,80,0.5,37,76,0.487,3,4,0.75,9,14,0.643
1/23/2015,14,NYK,ORL,W ,113,106,240,43,91,0.473,33,66,0.5,10,25,0.4,17,21,0.81,44,87,0.506,37,60,0.617,7,27,0.259,11,19,0.579
1/23/2015,7,PHI,TOR,L ,86,91,240,31,81,0.383,22,52,0.423,9,29,0.31,15,18,0.833,33,80,0.413,27,56,0.482,6,24,0.25,19,24,0.792
1/23/2015,6,PHO,HOU,L ,111,113,240,42,91,0.462,32,61,0.525,10,30,0.333,17,24,0.708,44,84,0.524,34,57,0.596,10,27,0.37,15,20,0.75
1/23/2015,0,SAS,LAL,W ,99,85,240,36,84,0.429,29,60,0.483,7,24,0.292,20,27,0.741,33,83,0.398,28,70,0.4,5,13,0.385,14,20,0.7
1/22/2015,5,CHI,SAS,W ,104,81,240,36,76,0.474,30,57,0.526,6,19,0.316,26,32,0.813,30,81,0.37,24,60,0.4,6,21,0.286,15,18,0.833
1/22/2015,2,LAC,BRK,W ,123,84,240,49,83,0.59,38,58,0.655,11,25,0.44,14,21,0.667,33,88,0.375,29,67,0.433,4,21,0.19,14,25,0.56
1/22/2015,5,MIL,UTA,L ,99,101,240,42,92,0.457,37,79,0.468,5,13,0.385,10,12,0.833,32,71,0.451,18,40,0.45,14,31,0.452,23,28,0.821
1/22/2015,12,POR,BOS,L ,89,90,240,33,89,0.371,24,61,0.393,9,28,0.321,14,19,0.737,39,87,0.448,32,68,0.471,7,19,0.368,5,7,0.714
1/21/2015,0,ATL,IND,W ,110,91,240,39,78,0.5,26,49,0.531,13,29,0.448,19,26,0.731,31,78,0.397,26,53,0.491,5,25,0.2,24,26,0.923
1/21/2015,5,CHO,MIA,W ,78,76,240,27,80,0.338,23,61,0.377,4,19,0.211,20,30,0.667,29,84,0.345,24,66,0.364,5,18,0.278,13,15,0.867
1/21/2015,4,CLE,UTA,W ,106,92,240,42,81,0.519,37,57,0.649,5,24,0.208,17,25,0.68,35,84,0.417,27,62,0.435,8,22,0.364,14,18,0.778
1/21/2015,0,DET,ORL,W ,128,118,240,49,94,0.521,39,70,0.557,10,24,0.417,20,24,0.833,48,97,0.495,42,82,0.512,6,15,0.4,16,16,1
1/21/2015,1,GSW,HOU,W ,126,113,240,49,98,0.5,36,69,0.522,13,29,0.448,15,18,0.833,37,87,0.425,24,55,0.436,13,32,0.406,26,31,0.839
1/21/2015,6,MEM,TOR,W ,92,86,240,34,74,0.459,33,67,0.493,1,7,0.143,23,29,0.793,27,85,0.318,22,57,0.386,5,28,0.179,27,32,0.844
1/21/2015,5,MIN,DAL,L ,75,98,240,31,89,0.348,29,74,0.392,2,15,0.133,11,15,0.733,39,76,0.513,28,49,0.571,11,27,0.407,9,14,0.643
1/21/2015,13,NOP,LAL,W ,96,80,240,38,83,0.458,35,67,0.522,3,16,0.188,17,21,0.81,28,77,0.364,22,57,0.386,6,20,0.3,18,21,0.857
1/21/2015,10,PHI,NYK,L ,91,98,240,29,79,0.367,21,56,0.375,8,23,0.348,25,32,0.781,37,91,0.407,30,71,0.423,7,20,0.35,17,20,0.85
1/21/2015,8,PHO,POR,W ,118,113,240,47,92,0.511,38,65,0.585,9,27,0.333,15,24,0.625,39,87,0.448,26,55,0.473,13,32,0.406,22,28,0.786
1/21/2015,2,SAC,BRK,L ,100,103,240,39,84,0.464,34,66,0.515,5,18,0.278,17,24,0.708,37,79,0.468,32,59,0.542,5,20,0.25,24,30,0.8
1/21/2015,9,WAS,OKC,L ,103,105,265,38,100,0.38,31,70,0.443,7,30,0.233,20,26,0.769,40,102,0.392,34,73,0.466,6,29,0.207,19,23,0.826
1/20/2015,5,DEN,SAS,L ,99,109,240,37,79,0.468,32,65,0.492,5,14,0.357,20,29,0.69,38,84,0.452,27,57,0.474,11,27,0.407,22,27,0.815
1/20/2015,5,MIA,OKC,L ,86,94,240,32,68,0.471,24,46,0.522,8,22,0.364,14,19,0.737,41,92,0.446,35,66,0.53,6,26,0.231,6,10,0.6
1/19/2015,4,ATL,DET,W ,93,82,240,37,84,0.44,28,54,0.519,9,30,0.3,10,14,0.714,29,82,0.354,20,47,0.426,9,35,0.257,15,26,0.577
1/19/2015,4,CHO,MIN,W ,105,80,240,40,89,0.449,28,67,0.418,12,22,0.545,13,19,0.684,29,80,0.363,23,61,0.377,6,19,0.316,16,20,0.8
1/19/2015,0,CLE,CHI,W ,108,94,240,41,90,0.456,33,72,0.458,8,18,0.444,18,25,0.72,30,80,0.375,22,64,0.344,8,16,0.5,26,32,0.813
1/19/2015,1,GSW,DEN,W ,122,79,240,44,81,0.543,31,54,0.574,13,27,0.481,21,27,0.778,30,87,0.345,23,63,0.365,7,24,0.292,12,19,0.632
1/19/2015,0,HOU,IND,W ,110,98,240,37,72,0.514,25,41,0.61,12,31,0.387,24,33,0.727,39,85,0.459,33,58,0.569,6,27,0.222,14,18,0.778
1/19/2015,0,LAC,BOS,W ,102,93,240,39,82,0.476,30,61,0.492,9,21,0.429,15,19,0.789,33,84,0.393,21,55,0.382,12,29,0.414,15,21,0.714
1/19/2015,4,MEM,DAL,L ,95,103,240,36,85,0.424,33,63,0.524,3,22,0.136,20,22,0.909,34,76,0.447,24,51,0.471,10,25,0.4,25,33,0.758
1/19/2015,9,MIL,TOR,L ,89,92,240,34,76,0.447,29,58,0.5,5,18,0.278,16,25,0.64,36,90,0.4,30,66,0.455,6,24,0.25,14,24,0.583
1/19/2015,2,NYK,NOP,W ,99,92,240,38,78,0.487,28,55,0.509,10,23,0.435,13,17,0.765,35,84,0.417,27,57,0.474,8,27,0.296,14,20,0.7
1/19/2015,13,PHO,LAL,W ,115,100,240,43,86,0.5,30,54,0.556,13,32,0.406,16,22,0.727,34,75,0.453,26,58,0.448,8,17,0.471,24,35,0.686
1/19/2015,9,POR,SAC,W ,98,94,240,35,88,0.398,24,52,0.462,11,36,0.306,17,26,0.654,34,76,0.447,30,64,0.469,4,12,0.333,22,30,0.733
1/19/2015,2,WAS,PHI,W ,111,76,240,45,81,0.556,38,68,0.559,7,13,0.538,14,18,0.778,28,85,0.329,22,61,0.361,6,24,0.25,14,23,0.609
1/18/2015,0,ORL,OKC,L ,99,127,240,35,88,0.398,27,65,0.415,8,23,0.348,21,27,0.778,48,83,0.578,39,58,0.672,9,25,0.36,22,32,0.688
1/18/2015,0,SAS,UTA,W ,89,69,240,31,80,0.388,23,63,0.365,8,17,0.471,19,23,0.826,28,84,0.333,25,74,0.338,3,10,0.3,10,16,0.625
1/18/2015,2,TOR,NOP,L ,93,95,240,31,72,0.431,24,47,0.511,7,25,0.28,24,29,0.828,39,82,0.476,34,65,0.523,5,17,0.294,12,20,0.6
1/17/2015,8,BRK,WAS,L ,90,99,240,36,82,0.439,32,65,0.492,4,17,0.235,14,18,0.778,40,77,0.519,35,61,0.574,5,16,0.313,14,27,0.519
1/17/2015,0,CHI,ATL,L ,99,107,240,37,80,0.463,28,54,0.519,9,26,0.346,16,20,0.8,40,84,0.476,29,58,0.5,11,26,0.423,16,21,0.762
1/17/2015,6,CHO,IND,W ,80,71,265,31,101,0.307,29,86,0.337,2,15,0.133,16,25,0.64,30,84,0.357,28,63,0.444,2,21,0.095,9,13,0.692
1/17/2015,7,DEN,MIN,L ,105,113,240,38,92,0.413,28,61,0.459,10,31,0.323,19,22,0.864,43,80,0.538,35,61,0.574,8,19,0.421,19,21,0.905
1/17/2015,0,DET,PHI,W ,107,89,240,38,88,0.432,23,53,0.434,15,35,0.429,16,19,0.842,38,82,0.463,31,54,0.574,7,28,0.25,6,7,0.857
1/17/2015,13,HOU,GSW,L ,106,131,240,37,88,0.42,30,65,0.462,7,23,0.304,25,34,0.735,50,91,0.549,41,69,0.594,9,22,0.409,22,33,0.667
1/17/2015,2,MEM,POR,W ,102,98,240,39,77,0.506,31,62,0.5,8,15,0.533,16,24,0.667,36,93,0.387,23,57,0.404,13,36,0.361,13,15,0.867
1/17/2015,16,SAC,LAC,L ,108,117,240,41,89,0.461,36,71,0.507,5,18,0.278,21,26,0.808,44,92,0.478,35,64,0.547,9,28,0.321,20,31,0.645
1/16/2015,9,BOS,CHI,L ,103,119,240,42,85,0.494,37,69,0.536,5,16,0.313,14,16,0.875,48,89,0.539,35,64,0.547,13,25,0.52,10,12,0.833
1/16/2015,0,DAL,DEN,W ,97,89,240,33,79,0.418,25,54,0.463,8,25,0.32,23,29,0.793,34,83,0.41,25,58,0.431,9,25,0.36,12,25,0.48
1/16/2015,8,IND,DET,L ,96,98,240,40,89,0.449,34,71,0.479,6,18,0.333,10,12,0.833,32,85,0.376,19,54,0.352,13,31,0.419,21,24,0.875
1/16/2015,16,LAC,CLE,L ,121,126,240,43,91,0.473,33,62,0.532,10,29,0.345,25,36,0.694,46,83,0.554,36,60,0.6,10,23,0.435,24,31,0.774
1/16/2015,7,OKC,GSW,W ,127,115,240,51,97,0.526,41,75,0.547,10,22,0.455,15,19,0.789,42,92,0.457,33,68,0.485,9,24,0.375,22,28,0.786
1/16/2015,7,ORL,MEM,L ,96,106,240,36,79,0.456,27,55,0.491,9,24,0.375,15,20,0.75,40,87,0.46,37,73,0.507,3,14,0.214,23,29,0.793
1/16/2015,0,PHI,NOP,W ,96,81,240,36,80,0.45,29,58,0.5,7,22,0.318,17,27,0.63,29,75,0.387,25,58,0.431,4,17,0.235,19,29,0.655
1/16/2015,8,PHO,MIN,W ,110,99,240,48,87,0.552,43,72,0.597,5,15,0.333,9,11,0.818,42,91,0.462,34,69,0.493,8,22,0.364,7,12,0.583
1/16/2015,10,SAC,MIA,L ,83,95,240,32,75,0.427,25,59,0.424,7,16,0.438,12,14,0.857,35,74,0.473,27,57,0.474,8,17,0.471,17,21,0.81
1/16/2015,1,SAS,POR,W ,110,96,240,42,94,0.447,31,65,0.477,11,29,0.379,15,17,0.882,37,74,0.5,31,55,0.564,6,19,0.316,16,20,0.8
1/16/2015,4,TOR,ATL,L ,89,110,240,35,82,0.427,29,57,0.509,6,25,0.24,13,17,0.765,42,69,0.609,30,46,0.652,12,23,0.522,14,16,0.875
1/16/2015,12,UTA,LAL,W ,94,85,240,36,85,0.424,24,54,0.444,12,31,0.387,10,10,1,31,65,0.477,28,58,0.483,3,7,0.429,20,27,0.741
1/16/2015,11,WAS,BRK,L ,80,102,240,31,73,0.425,27,56,0.482,4,17,0.235,14,16,0.875,37,81,0.457,33,69,0.478,4,12,0.333,24,31,0.774
1/15/2015,1,HOU,OKC,W ,112,101,240,41,86,0.477,25,50,0.5,16,36,0.444,14,19,0.737,35,81,0.432,24,52,0.462,11,29,0.379,20,28,0.714
1/15/2015,16,LAL,CLE,L ,102,109,240,39,76,0.513,31,52,0.596,8,24,0.333,16,23,0.696,37,78,0.474,28,48,0.583,9,30,0.3,26,36,0.722
1/15/2015,0,MIL,NYK,W ,95,79,240,28,72,0.389,20,54,0.37,8,18,0.444,31,42,0.738,28,68,0.412,20,46,0.435,8,22,0.364,15,20,0.75
1/14/2015,5,BOS,ATL,L ,91,105,240,34,83,0.41,23,50,0.46,11,33,0.333,12,14,0.857,36,73,0.493,26,44,0.591,10,29,0.345,23,27,0.852
1/14/2015,5,BRK,MEM,L ,92,103,240,36,75,0.48,26,49,0.531,10,26,0.385,10,12,0.833,39,83,0.47,36,66,0.545,3,17,0.176,22,29,0.759
1/14/2015,7,CHI,WAS,L ,99,105,240,34,79,0.43,21,52,0.404,13,27,0.481,18,24,0.75,40,78,0.513,35,63,0.556,5,15,0.333,20,25,0.8
1/14/2015,1,CHO,SAS,L ,93,98,240,33,86,0.384,29,73,0.397,4,13,0.308,23,35,0.657,37,85,0.435,29,64,0.453,8,21,0.381,16,20,0.8
1/14/2015,1,DEN,DAL,W ,114,107,240,41,82,0.5,37,63,0.587,4,19,0.211,28,35,0.8,41,100,0.41,32,63,0.508,9,37,0.243,16,20,0.8
1/14/2015,0,DET,NOP,L ,94,105,240,34,73,0.466,26,51,0.51,8,22,0.364,18,23,0.783,39,80,0.488,31,59,0.525,8,21,0.381,19,23,0.826
1/14/2015,1,GSW,MIA,W ,104,89,240,38,81,0.469,25,52,0.481,13,29,0.448,15,19,0.789,30,71,0.423,24,53,0.453,6,18,0.333,23,27,0.852
1/14/2015,18,ORL,HOU,W ,120,113,240,44,90,0.489,35,64,0.547,9,26,0.346,23,26,0.885,42,83,0.506,33,57,0.579,9,26,0.346,20,23,0.87
1/14/2015,3,POR,LAC,L ,94,100,240,35,87,0.402,29,61,0.475,6,26,0.231,18,20,0.9,37,88,0.42,29,65,0.446,8,23,0.348,18,19,0.947
1/14/2015,0,TOR,PHI,W ,100,84,240,38,82,0.463,28,53,0.528,10,29,0.345,14,22,0.636,31,80,0.388,28,61,0.459,3,19,0.158,19,31,0.613
1/13/2015,11,IND,MIN,L ,101,110,240,39,80,0.488,34,62,0.548,5,18,0.278,18,30,0.6,41,87,0.471,31,67,0.463,10,20,0.5,18,19,0.947
1/13/2015,0,LAL,MIA,L ,75,78,240,29,92,0.315,25,69,0.362,4,23,0.174,13,18,0.722,33,78,0.423,31,62,0.5,2,16,0.125,10,15,0.667
1/13/2015,3,PHI,ATL,L ,87,105,240,31,76,0.408,22,51,0.431,9,25,0.36,16,25,0.64,42,87,0.483,30,64,0.469,12,23,0.522,9,16,0.563
1/13/2015,10,PHO,CLE,W ,107,100,240,40,76,0.526,33,56,0.589,7,20,0.35,20,27,0.741,36,82,0.439,23,47,0.489,13,35,0.371,15,20,0.75
1/13/2015,8,SAC,DAL,L ,104,108,265,38,86,0.442,37,68,0.544,1,18,0.056,27,34,0.794,43,100,0.43,37,76,0.487,6,24,0.25,16,23,0.696
1/13/2015,3,UTA,GSW,L ,105,116,240,39,81,0.481,32,60,0.533,7,21,0.333,20,24,0.833,46,91,0.505,33,66,0.5,13,25,0.52,11,13,0.846
1/13/2015,11,WAS,SAS,W ,101,93,240,37,75,0.493,31,63,0.492,6,12,0.5,21,24,0.875,38,96,0.396,29,67,0.433,9,29,0.31,8,12,0.667
1/12/2015,14,BOS,NOP,W ,108,100,240,37,88,0.42,29,64,0.453,8,24,0.333,26,31,0.839,31,75,0.413,25,60,0.417,6,15,0.4,32,37,0.865
1/12/2015,4,BRK,HOU,L ,99,113,240,39,84,0.464,34,63,0.54,5,21,0.238,16,18,0.889,41,86,0.477,25,46,0.543,16,40,0.4,15,20,0.75
1/12/2015,4,CHI,ORL,L ,114,121,240,41,84,0.488,33,57,0.579,8,27,0.296,24,33,0.727,48,81,0.593,41,63,0.651,7,18,0.389,18,29,0.621
1/12/2015,10,TOR,DET,L ,111,114,240,47,87,0.54,40,60,0.667,7,27,0.259,10,14,0.714,41,96,0.427,34,75,0.453,7,21,0.333,25,31,0.806
1/11/2015,0,ATL,WAS,W ,120,89,240,42,89,0.472,26,58,0.448,16,31,0.516,20,24,0.833,36,76,0.474,31,56,0.554,5,20,0.25,12,15,0.8
1/11/2015,3,LAC,MIA,L ,90,104,240,34,75,0.453,25,49,0.51,9,26,0.346,13,18,0.722,39,81,0.481,33,60,0.55,6,21,0.286,20,24,0.833
1/11/2015,14,LAL,POR,L ,94,106,240,36,81,0.444,29,59,0.492,7,22,0.318,15,19,0.789,41,86,0.477,28,55,0.509,13,31,0.419,11,17,0.647
1/11/2015,5,MEM,PHO,W ,122,110,290,48,100,0.48,39,79,0.494,9,21,0.429,17,24,0.708,42,100,0.42,34,65,0.523,8,35,0.229,18,23,0.783
1/11/2015,4,SAC,CLE,W ,103,84,240,42,86,0.488,36,69,0.522,6,17,0.353,13,17,0.765,33,78,0.423,22,46,0.478,11,32,0.344,7,12,0.583
1/10/2015,2,CHI,MIL,W ,95,87,240,35,88,0.398,31,71,0.437,4,17,0.235,21,24,0.875,36,81,0.444,33,70,0.471,3,11,0.273,12,16,0.75
1/10/2015,10,DET,BRK,W ,98,93,240,34,80,0.425,23,47,0.489,11,33,0.333,19,26,0.731,37,88,0.42,28,57,0.491,9,31,0.29,10,10,1
1/10/2015,8,HOU,UTA,W ,97,82,240,33,77,0.429,20,43,0.465,13,34,0.382,18,21,0.857,29,70,0.414,24,53,0.453,5,17,0.294,19,21,0.905
1/10/2015,6,LAC,DAL,W ,120,100,240,46,88,0.523,33,57,0.579,13,31,0.419,15,21,0.714,38,86,0.442,26,56,0.464,12,30,0.4,12,17,0.706
1/10/2015,4,MIN,SAS,L ,93,108,240,32,81,0.395,29,66,0.439,3,15,0.2,26,26,1,41,84,0.488,32,60,0.533,9,24,0.375,17,20,0.85
1/10/2015,3,NYK,CHO,L ,82,110,240,33,85,0.388,25,56,0.446,8,29,0.276,8,9,0.889,39,78,0.5,32,62,0.516,7,16,0.438,25,33,0.758
1/10/2015,15,PHI,IND,W ,93,92,240,32,80,0.4,21,56,0.375,11,24,0.458,18,25,0.72,29,87,0.333,25,69,0.362,4,18,0.222,30,42,0.714
1/10/2015,18,POR,ORL,W ,103,92,240,36,76,0.474,26,50,0.52,10,26,0.385,21,26,0.808,37,92,0.402,34,71,0.479,3,21,0.143,15,20,0.75
1/10/2015,7,TOR,BOS,W ,109,96,240,41,91,0.451,28,61,0.459,13,30,0.433,14,19,0.737,39,83,0.47,33,65,0.508,6,18,0.333,12,20,0.6
1/9/2015,3,BRK,PHI,L ,88,90,240,33,73,0.452,30,57,0.526,3,16,0.188,19,27,0.704,36,79,0.456,28,62,0.452,8,17,0.471,10,17,0.588
1/9/2015,1,DET,ATL,L ,103,106,240,38,96,0.396,25,53,0.472,13,43,0.302,14,18,0.778,40,82,0.488,30,59,0.508,10,23,0.435,16,24,0.667
1/9/2015,9,GSW,CLE,W ,112,94,240,43,86,0.5,33,56,0.589,10,30,0.333,16,17,0.941,35,86,0.407,28,63,0.444,7,23,0.304,17,23,0.739
1/9/2015,6,IND,BOS,W ,107,103,265,34,92,0.37,25,69,0.362,9,23,0.391,30,34,0.882,41,103,0.398,31,69,0.449,10,34,0.294,11,16,0.688
1/9/2015,1,LAL,ORL,W ,101,84,240,36,90,0.4,29,69,0.42,7,21,0.333,22,31,0.71,30,76,0.395,24,62,0.387,6,14,0.429,18,23,0.783
1/9/2015,7,MIL,MIN,W ,98,84,240,39,75,0.52,27,56,0.482,12,19,0.632,8,10,0.8,32,79,0.405,26,57,0.456,6,22,0.273,14,17,0.824
1/9/2015,0,NOP,MEM,W ,106,95,240,37,81,0.457,27,61,0.443,10,20,0.5,22,26,0.846,36,82,0.439,30,65,0.462,6,17,0.353,17,22,0.773
1/9/2015,5,OKC,UTA,W ,99,94,240,42,91,0.462,35,70,0.5,7,21,0.333,8,9,0.889,36,74,0.486,29,53,0.547,7,21,0.333,15,22,0.682
1/9/2015,7,SAC,DEN,L ,108,118,240,42,86,0.488,36,67,0.537,6,19,0.316,18,24,0.75,47,85,0.553,42,68,0.618,5,17,0.294,19,28,0.679
1/9/2015,4,SAS,PHO,W ,100,95,240,38,89,0.427,27,66,0.409,11,23,0.478,13,18,0.722,37,83,0.446,30,57,0.526,7,26,0.269,14,21,0.667
1/9/2015,1,WAS,CHI,W ,102,86,240,41,86,0.477,33,71,0.465,8,15,0.533,12,19,0.632,32,83,0.386,22,57,0.386,10,26,0.385,12,19,0.632
1/8/2015,1,NYK,HOU,L ,96,120,240,37,80,0.463,26,54,0.481,11,26,0.423,11,21,0.524,41,77,0.532,25,41,0.61,16,36,0.444,22,32,0.688
1/8/2015,1,POR,MIA,W ,99,83,240,40,95,0.421,32,68,0.471,8,27,0.296,11,15,0.733,29,77,0.377,26,63,0.413,3,14,0.214,22,30,0.733
1/8/2015,3,TOR,CHO,L ,95,103,240,33,83,0.398,23,52,0.442,10,31,0.323,19,25,0.76,42,88,0.477,38,72,0.528,4,16,0.25,15,22,0.682
1/7/2015,8,ATL,MEM,W ,96,86,240,32,72,0.444,19,47,0.404,13,25,0.52,19,23,0.826,35,79,0.443,30,62,0.484,5,17,0.294,11,11,1
1/7/2015,7,BRK,BOS,L ,81,89,240,30,74,0.405,27,60,0.45,3,14,0.214,18,26,0.692,35,88,0.398,30,70,0.429,5,18,0.278,14,17,0.824
1/7/2015,4,CHI,UTA,L ,77,97,240,28,84,0.333,22,64,0.344,6,20,0.3,15,20,0.75,37,78,0.474,32,62,0.516,5,16,0.313,18,24,0.75
1/7/2015,9,CHO,NOP,W ,98,94,240,37,86,0.43,33,72,0.458,4,14,0.286,20,26,0.769,36,80,0.45,30,62,0.484,6,18,0.333,16,24,0.667
1/7/2015,14,CLE,HOU,L ,93,105,240,34,82,0.415,24,53,0.453,10,29,0.345,15,19,0.789,39,86,0.453,27,52,0.519,12,34,0.353,15,24,0.625
1/7/2015,0,DAL,DET,L ,95,108,240,38,87,0.437,32,65,0.492,6,22,0.273,13,18,0.722,43,97,0.443,33,76,0.434,10,21,0.476,12,14,0.857
1/7/2015,4,DEN,ORL,W ,93,90,240,33,74,0.446,26,57,0.456,7,17,0.412,20,26,0.769,35,88,0.398,27,66,0.409,8,22,0.364,12,16,0.75
1/7/2015,7,GSW,IND,W ,117,102,240,45,91,0.495,33,63,0.524,12,28,0.429,15,20,0.75,37,81,0.457,31,55,0.564,6,26,0.231,22,23,0.957
1/7/2015,0,LAC,LAL,W ,114,89,240,40,85,0.471,28,52,0.538,12,33,0.364,22,30,0.733,37,85,0.435,32,65,0.492,5,20,0.25,10,17,0.588
1/7/2015,12,MIN,PHO,L ,111,113,240,44,92,0.478,37,75,0.493,7,17,0.412,16,19,0.842,46,96,0.479,41,70,0.586,5,26,0.192,16,19,0.842
1/7/2015,0,PHI,MIL,L ,77,97,240,25,83,0.301,23,58,0.397,2,25,0.08,25,29,0.862,41,76,0.539,33,59,0.559,8,17,0.471,7,11,0.636
1/7/2015,0,SAC,OKC,W ,104,83,240,36,92,0.391,26,73,0.356,10,19,0.526,22,28,0.786,29,89,0.326,20,59,0.339,9,30,0.3,16,23,0.696
1/7/2015,0,WAS,NYK,W ,101,91,240,39,76,0.513,31,60,0.517,8,16,0.5,15,21,0.714,34,82,0.415,23,56,0.411,11,26,0.423,12,16,0.75
1/6/2015,12,MIL,PHO,L ,96,102,240,37,88,0.42,34,68,0.5,3,20,0.15,19,22,0.864,37,81,0.457,30,56,0.536,7,25,0.28,21,27,0.778
1/6/2015,11,SAS,DET,L ,104,105,240,36,79,0.456,27,58,0.466,9,21,0.429,23,34,0.676,41,87,0.471,38,68,0.559,3,19,0.158,20,28,0.714
1/5/2015,1,BOS,CHO,L ,95,104,240,36,91,0.396,29,73,0.397,7,18,0.389,16,23,0.696,38,78,0.487,32,59,0.542,6,19,0.316,22,23,0.957
1/5/2015,7,BRK,DAL,L ,88,96,265,33,84,0.393,30,59,0.508,3,25,0.12,19,23,0.826,37,94,0.394,27,67,0.403,10,27,0.37,12,19,0.632
1/5/2015,14,CHI,HOU,W ,114,105,240,41,85,0.482,36,68,0.529,5,17,0.294,27,30,0.9,47,102,0.461,39,77,0.506,8,25,0.32,3,5,0.6
1/5/2015,1,GSW,OKC,W ,117,91,240,41,88,0.466,26,60,0.433,15,28,0.536,20,32,0.625,30,98,0.306,25,70,0.357,5,28,0.179,26,34,0.765
1/5/2015,3,LAC,ATL,L ,98,107,240,33,74,0.446,26,49,0.531,7,25,0.28,25,33,0.758,36,81,0.444,23,54,0.426,13,27,0.481,22,33,0.667
1/5/2015,2,MEM,NYK,W ,105,83,240,43,82,0.524,36,67,0.537,7,15,0.467,12,19,0.632,33,76,0.434,25,50,0.5,8,26,0.308,9,13,0.692
1/5/2015,1,MIN,DEN,L ,101,110,240,38,89,0.427,28,65,0.431,10,24,0.417,15,18,0.833,46,84,0.548,39,65,0.6,7,19,0.368,11,16,0.688
1/5/2015,2,NOP,WAS,L ,85,92,240,33,74,0.446,27,55,0.491,6,19,0.316,13,17,0.765,38,79,0.481,36,69,0.522,2,10,0.2,14,17,0.824
1/5/2015,9,PHI,CLE,W ,95,92,240,38,79,0.481,31,56,0.554,7,23,0.304,12,15,0.8,33,85,0.388,22,55,0.4,11,30,0.367,15,22,0.682
1/5/2015,14,POR,LAL,W ,98,94,240,33,83,0.398,22,57,0.386,11,26,0.423,21,24,0.875,37,88,0.42,33,74,0.446,4,14,0.286,16,20,0.8
1/5/2015,1,UTA,IND,L ,101,105,240,35,81,0.432,31,58,0.534,4,23,0.174,27,34,0.794,35,74,0.473,28,61,0.459,7,13,0.538,28,30,0.933
1/4/2015,8,CLE,DAL,L ,90,109,240,35,86,0.407,27,61,0.443,8,25,0.32,12,17,0.706,44,78,0.564,32,52,0.615,12,26,0.462,9,11,0.818
1/4/2015,3,DET,SAC,W ,114,95,240,45,91,0.495,33,60,0.55,12,31,0.387,12,16,0.75,32,75,0.427,29,60,0.483,3,15,0.2,28,36,0.778
1/4/2015,10,LAL,IND,W ,88,87,240,27,71,0.38,21,53,0.396,6,18,0.333,28,30,0.933,33,90,0.367,25,62,0.403,8,28,0.286,13,18,0.722
1/4/2015,0,MIA,BRK,W ,88,84,240,31,67,0.463,26,53,0.491,5,14,0.357,21,28,0.75,34,86,0.395,27,62,0.435,7,24,0.292,9,13,0.692
1/4/2015,11,NYK,MIL,L ,82,95,240,31,76,0.408,22,51,0.431,9,25,0.36,11,14,0.786,35,77,0.455,31,61,0.508,4,16,0.25,21,27,0.778
1/4/2015,4,PHO,TOR,W ,125,109,240,48,89,0.539,40,66,0.606,8,23,0.348,21,28,0.75,38,83,0.458,29,57,0.509,9,26,0.346,24,29,0.828
1/3/2015,16,CHI,BOS,W ,109,104,265,37,100,0.37,31,72,0.431,6,28,0.214,29,40,0.725,45,100,0.45,40,83,0.482,5,17,0.294,9,11,0.818
1/3/2015,10,DEN,MEM,W ,114,85,240,41,79,0.519,34,64,0.531,7,15,0.467,25,31,0.806,37,86,0.43,35,72,0.486,2,14,0.143,9,13,0.692
1/3/2015,5,HOU,MIA,W ,115,79,240,41,83,0.494,28,52,0.538,13,31,0.419,20,28,0.714,30,68,0.441,26,51,0.51,4,17,0.235,15,25,0.6
1/3/2015,2,LAC,PHI,W ,127,91,240,46,85,0.541,31,48,0.646,15,37,0.405,20,26,0.769,32,79,0.405,23,54,0.426,9,25,0.36,18,26,0.692
1/3/2015,11,MIN,UTA,L ,89,101,240,34,86,0.395,28,67,0.418,6,19,0.316,15,18,0.833,38,75,0.507,27,55,0.491,11,20,0.55,14,21,0.667
1/3/2015,4,ORL,CHO,L ,90,98,240,33,87,0.379,29,68,0.426,4,19,0.211,20,21,0.952,35,78,0.449,31,62,0.5,4,16,0.25,24,32,0.75
1/3/2015,1,POR,ATL,L ,107,115,240,42,93,0.452,29,60,0.483,13,33,0.394,10,12,0.833,43,84,0.512,37,67,0.552,6,17,0.353,23,31,0.742
1/3/2015,14,SAS,WAS,W ,101,92,240,43,78,0.551,39,62,0.629,4,16,0.25,11,18,0.611,40,82,0.488,36,68,0.529,4,14,0.286,8,13,0.615
1/2/2015,0,BOS,DAL,L ,101,119,240,38,89,0.427,26,55,0.473,12,34,0.353,13,19,0.684,45,96,0.469,32,69,0.464,13,27,0.481,16,17,0.941
1/2/2015,7,CHO,CLE,L ,87,91,240,32,87,0.368,26,59,0.441,6,28,0.214,17,26,0.654,33,87,0.379,29,72,0.403,4,15,0.267,21,30,0.7
1/2/2015,2,GSW,TOR,W ,126,105,240,49,92,0.533,37,64,0.578,12,28,0.429,16,20,0.8,40,86,0.465,30,61,0.492,10,25,0.4,15,20,0.75
1/2/2015,12,LAL,MEM,L ,106,109,240,43,81,0.531,37,62,0.597,6,19,0.316,14,19,0.737,41,84,0.488,35,70,0.5,6,14,0.429,21,31,0.677
1/2/2015,12,MIL,IND,L ,91,94,240,38,89,0.427,31,65,0.477,7,24,0.292,8,10,0.8,35,81,0.432,27,61,0.443,8,20,0.4,16,20,0.8
1/2/2015,0,NOP,HOU,W ,111,83,240,44,83,0.53,37,68,0.544,7,15,0.467,16,20,0.8,35,88,0.398,29,59,0.492,6,29,0.207,7,11,0.636
1/2/2015,2,NYK,DET,L ,81,97,240,32,91,0.352,22,67,0.328,10,24,0.417,7,14,0.5,38,76,0.5,25,43,0.581,13,33,0.394,8,14,0.571
1/2/2015,13,OKC,WAS,W ,109,102,240,44,83,0.53,36,64,0.563,8,19,0.421,13,19,0.684,39,84,0.464,28,63,0.444,11,21,0.524,13,15,0.867
1/2/2015,7,ORL,BRK,L ,98,100,240,37,88,0.42,26,66,0.394,11,22,0.5,13,20,0.65,41,72,0.569,34,52,0.654,7,20,0.35,11,18,0.611
1/2/2015,5,PHO,PHI,W ,112,96,240,42,84,0.5,28,52,0.538,14,32,0.438,14,16,0.875,37,87,0.425,30,61,0.492,7,26,0.269,15,25,0.6
1/2/2015,1,UTA,ATL,L ,92,98,240,32,86,0.372,22,55,0.4,10,31,0.323,18,24,0.75,33,81,0.407,27,58,0.466,6,23,0.261,26,30,0.867
1/1/2015,15,CHI,DEN,W ,106,101,240,38,91,0.418,30,76,0.395,8,15,0.533,22,25,0.88,37,92,0.402,32,78,0.41,5,14,0.357,22,27,0.815
1/1/2015,0,MIN,SAC,L ,107,110,240,42,91,0.462,35,67,0.522,7,24,0.292,16,22,0.727,40,74,0.541,35,62,0.565,5,12,0.417,25,29,0.862
12/31/2014,0,BOS,SAC,W ,106,84,240,44,94,0.468,39,73,0.534,5,21,0.238,13,15,0.867,32,87,0.368,30,72,0.417,2,15,0.133,18,28,0.643
12/31/2014,2,CLE,MIL,L ,80,96,240,29,85,0.341,21,54,0.389,8,31,0.258,14,16,0.875,40,90,0.444,29,65,0.446,11,25,0.44,5,10,0.5
12/31/2014,9,HOU,CHO,W ,102,83,240,38,88,0.432,21,45,0.467,17,43,0.395,9,14,0.643,29,76,0.382,26,58,0.448,3,18,0.167,22,26,0.846
12/31/2014,3,IND,MIA,W ,106,95,240,35,79,0.443,25,61,0.41,10,18,0.556,26,30,0.867,38,77,0.494,33,61,0.541,5,16,0.313,14,18,0.778
12/31/2014,1,LAC,NYK,W ,99,78,240,36,82,0.439,21,48,0.438,15,34,0.441,12,20,0.6,32,84,0.381,28,67,0.418,4,17,0.235,10,15,0.667
12/31/2014,7,OKC,PHO,W ,137,134,265,41,99,0.414,30,64,0.469,11,35,0.314,44,49,0.898,46,90,0.511,33,63,0.524,13,27,0.481,29,35,0.829
12/31/2014,10,SAS,NOP,W ,95,93,265,39,89,0.438,33,65,0.508,6,24,0.25,11,18,0.611,34,89,0.382,26,61,0.426,8,28,0.286,17,20,0.85
12/30/2014,14,ATL,CLE,W ,109,101,240,40,79,0.506,30,50,0.6,10,29,0.345,19,26,0.731,37,84,0.44,24,53,0.453,13,31,0.419,14,21,0.667
12/30/2014,6,CHI,BRK,L ,82,96,240,33,86,0.384,25,61,0.41,8,25,0.32,8,15,0.533,36,83,0.434,30,69,0.435,6,14,0.429,18,21,0.857
12/30/2014,4,DAL,WAS,W ,114,87,240,43,82,0.524,35,67,0.522,8,15,0.533,20,29,0.69,33,74,0.446,29,62,0.468,4,12,0.333,17,27,0.63
12/30/2014,3,DEN,LAL,L ,103,111,240,39,87,0.448,31,61,0.508,8,26,0.308,17,27,0.63,40,76,0.526,26,51,0.51,14,25,0.56,17,26,0.654
12/30/2014,1,GSW,PHI,W ,126,86,240,46,82,0.561,34,54,0.63,12,28,0.429,22,27,0.815,33,86,0.384,27,66,0.409,6,20,0.3,14,23,0.609
12/30/2014,3,MEM,SAS,W ,95,87,240,35,72,0.486,28,57,0.491,7,15,0.467,18,22,0.818,35,78,0.449,30,56,0.536,5,22,0.227,12,17,0.706
12/30/2014,5,NOP,PHO,W ,110,106,240,42,81,0.519,34,63,0.54,8,18,0.444,18,29,0.621,41,86,0.477,32,65,0.492,9,21,0.429,15,19,0.789
12/30/2014,5,ORL,DET,L ,86,109,240,38,85,0.447,34,65,0.523,4,20,0.2,6,10,0.6,40,86,0.465,26,53,0.491,14,33,0.424,15,29,0.517
12/30/2014,7,POR,TOR,W ,102,97,265,38,95,0.4,26,59,0.441,12,36,0.333,14,18,0.778,40,99,0.404,36,77,0.468,4,22,0.182,13,15,0.867
12/30/2014,20,UTA,MIN,W ,100,94,240,38,79,0.481,31,60,0.517,7,19,0.368,17,22,0.773,38,82,0.463,30,65,0.462,8,17,0.471,10,14,0.714
12/29/2014,12,BRK,SAC,W ,107,99,240,36,80,0.45,28,59,0.475,8,21,0.381,27,39,0.692,37,76,0.487,28,56,0.5,9,20,0.45,16,20,0.8
12/29/2014,3,CHO,MIL,L ,94,104,265,33,90,0.367,26,65,0.4,7,25,0.28,21,26,0.808,40,85,0.471,34,64,0.531,6,21,0.286,18,21,0.857
12/29/2014,5,HOU,WAS,L ,103,104,240,40,86,0.465,31,57,0.544,9,29,0.31,14,23,0.609,35,73,0.479,27,55,0.491,8,18,0.444,26,28,0.929
12/29/2014,8,IND,CHI,L ,90,92,240,36,83,0.434,31,70,0.443,5,13,0.385,13,21,0.619,29,84,0.345,24,71,0.338,5,13,0.385,29,33,0.879
12/29/2014,10,LAC,UTA,W ,101,97,240,37,81,0.457,27,58,0.466,10,23,0.435,17,22,0.773,38,92,0.413,30,73,0.411,8,19,0.421,13,22,0.591
12/29/2014,16,MIA,ORL,L ,101,102,240,33,63,0.524,26,49,0.531,7,14,0.5,28,40,0.7,41,77,0.532,30,52,0.577,11,25,0.44,9,13,0.692
12/28/2014,2,CLE,DET,L ,80,103,240,31,82,0.378,26,53,0.491,5,29,0.172,13,17,0.765,41,91,0.451,24,60,0.4,17,31,0.548,4,9,0.444
12/28/2014,9,DAL,OKC,W ,112,107,240,39,88,0.443,29,57,0.509,10,31,0.323,24,28,0.857,45,90,0.5,40,76,0.526,5,14,0.357,12,21,0.571
12/28/2014,12,DEN,TOR,L ,102,116,240,37,87,0.425,33,70,0.471,4,17,0.235,24,34,0.706,43,88,0.489,33,65,0.508,10,23,0.435,20,32,0.625
12/28/2014,4,LAL,PHO,L ,107,116,240,42,81,0.519,30,61,0.492,12,20,0.6,11,20,0.55,44,87,0.506,35,65,0.538,9,22,0.409,19,24,0.792
12/28/2014,0,POR,NYK,W ,101,79,240,38,81,0.469,22,45,0.489,16,36,0.444,9,12,0.75,31,93,0.333,24,66,0.364,7,27,0.259,10,15,0.667
12/28/2014,20,SAS,HOU,W ,110,106,240,39,83,0.47,28,53,0.528,11,30,0.367,21,24,0.875,38,77,0.494,26,44,0.591,12,33,0.364,18,31,0.581
12/27/2014,12,BRK,IND,L ,85,110,240,28,77,0.364,21,52,0.404,7,25,0.28,22,27,0.815,44,86,0.512,35,68,0.515,9,18,0.5,13,18,0.722
12/27/2014,12,CHI,NOP,W ,107,100,240,41,89,0.461,35,69,0.507,6,20,0.3,19,22,0.864,41,88,0.466,37,74,0.5,4,14,0.286,14,16,0.875
12/27/2014,4,CHO,ORL,L ,94,102,240,36,86,0.419,28,62,0.452,8,24,0.333,14,18,0.778,38,83,0.458,30,63,0.476,8,20,0.4,18,24,0.75
12/27/2014,6,GSW,MIN,W ,110,97,240,41,88,0.466,30,60,0.5,11,28,0.393,17,21,0.81,34,77,0.442,26,58,0.448,8,19,0.421,21,36,0.583
12/27/2014,2,LAC,TOR,L ,98,110,240,37,81,0.457,25,56,0.446,12,25,0.48,12,15,0.8,41,86,0.477,28,52,0.538,13,34,0.382,15,19,0.789
12/27/2014,0,MIA,MEM,L ,95,103,240,37,72,0.514,31,52,0.596,6,20,0.3,15,21,0.714,34,73,0.466,27,57,0.474,7,16,0.438,28,37,0.757
12/27/2014,8,MIL,ATL,L ,85,90,240,31,80,0.388,19,50,0.38,12,30,0.4,11,14,0.786,33,90,0.367,24,61,0.393,9,29,0.31,15,19,0.789
12/27/2014,2,SAC,NYK,W ,135,129,265,49,89,0.551,41,73,0.562,8,16,0.5,29,33,0.879,48,97,0.495,42,77,0.545,6,20,0.3,27,32,0.844
12/27/2014,2,UTA,PHI,W ,88,71,240,30,84,0.357,26,61,0.426,4,23,0.174,24,28,0.857,24,74,0.324,19,48,0.396,5,26,0.192,18,28,0.643
12/27/2014,0,WAS,BOS,W ,101,88,240,45,90,0.5,40,77,0.519,5,13,0.385,6,10,0.6,32,79,0.405,26,55,0.473,6,24,0.25,18,24,0.75
12/26/2014,3,ATL,MIL,L ,77,107,240,31,76,0.408,27,53,0.509,4,23,0.174,11,14,0.786,40,79,0.506,32,60,0.533,8,19,0.421,19,23,0.826
12/26/2014,9,BOS,BRK,L ,107,109,240,45,87,0.517,36,63,0.571,9,24,0.375,8,11,0.727,41,83,0.494,34,62,0.548,7,21,0.333,20,28,0.714
12/26/2014,0,DAL,LAL,W ,102,98,240,42,83,0.506,37,65,0.569,5,18,0.278,13,24,0.542,36,99,0.364,25,70,0.357,11,29,0.379,15,20,0.75
12/26/2014,10,DEN,MIN,W ,106,102,240,39,95,0.411,36,76,0.474,3,19,0.158,25,32,0.781,41,103,0.398,38,88,0.432,3,15,0.2,17,24,0.708
12/26/2014,2,DET,IND,W ,119,109,240,47,86,0.547,37,60,0.617,10,26,0.385,15,29,0.517,42,83,0.506,33,63,0.524,9,20,0.45,16,22,0.727
12/26/2014,6,MEM,HOU,L ,111,117,265,43,104,0.413,36,80,0.45,7,24,0.292,18,23,0.783,41,91,0.451,27,57,0.474,14,34,0.412,21,28,0.75
12/26/2014,9,NOP,SAS,W ,97,90,240,35,84,0.417,29,67,0.433,6,17,0.353,21,24,0.875,37,75,0.493,31,61,0.508,6,14,0.429,10,14,0.714
12/26/2014,1,OKC,CHO,W ,98,75,240,36,88,0.409,28,61,0.459,8,27,0.296,18,21,0.857,25,87,0.287,20,63,0.317,5,24,0.208,20,26,0.769
12/26/2014,11,ORL,CLE,L ,89,98,240,36,73,0.493,27,52,0.519,9,21,0.429,8,12,0.667,33,80,0.413,25,50,0.5,8,30,0.267,24,26,0.923
12/26/2014,2,POR,PHI,W ,114,93,240,42,88,0.477,24,45,0.533,18,43,0.419,12,14,0.857,36,81,0.444,33,67,0.493,3,14,0.214,18,33,0.545
12/26/2014,11,SAC,PHO,L ,106,115,240,41,93,0.441,34,73,0.466,7,20,0.35,17,24,0.708,46,94,0.489,32,61,0.525,14,33,0.424,9,12,0.75
12/25/2014,4,CHI,LAL,W ,113,93,240,42,86,0.488,32,62,0.516,10,24,0.417,19,25,0.76,36,92,0.391,31,76,0.408,5,16,0.313,16,21,0.762
12/25/2014,4,LAC,GSW,W ,100,86,240,34,87,0.391,25,55,0.455,9,32,0.281,23,31,0.742,34,80,0.425,28,52,0.538,6,28,0.214,12,22,0.545
12/25/2014,3,MIA,CLE,W ,101,91,240,40,84,0.476,33,63,0.524,7,21,0.333,14,17,0.824,32,72,0.444,26,46,0.565,6,26,0.231,21,33,0.636
12/25/2014,0,NYK,WAS,L ,91,102,240,36,80,0.45,32,58,0.552,4,22,0.182,15,19,0.789,44,86,0.512,37,70,0.529,7,16,0.438,7,10,0.7
12/25/2014,10,SAS,OKC,L ,106,114,240,42,81,0.519,35,58,0.603,7,23,0.304,15,21,0.714,42,81,0.519,33,66,0.5,9,15,0.6,21,38,0.553
12/23/2014,7,ATL,LAC,W ,107,104,240,34,76,0.447,22,53,0.415,12,23,0.522,27,35,0.771,37,92,0.402,26,63,0.413,11,29,0.379,19,28,0.679
12/23/2014,9,BRK,DEN,W ,102,96,240,43,91,0.473,37,68,0.544,6,23,0.261,10,14,0.714,36,82,0.439,29,57,0.509,7,25,0.28,17,22,0.773
12/23/2014,6,CLE,MIN,W ,125,104,240,44,84,0.524,32,60,0.533,12,24,0.5,25,31,0.806,39,88,0.443,35,75,0.467,4,13,0.308,22,29,0.759
12/23/2014,3,IND,NOP,W ,96,84,240,39,78,0.5,34,63,0.54,5,15,0.333,13,18,0.722,33,83,0.398,29,63,0.46,4,20,0.2,14,19,0.737
12/23/2014,3,LAL,GSW,W ,115,105,240,46,89,0.517,34,63,0.54,12,26,0.462,11,17,0.647,39,84,0.464,27,58,0.466,12,26,0.462,15,17,0.882
12/23/2014,2,MIA,PHI,L ,87,91,240,33,80,0.413,25,54,0.463,8,26,0.308,13,18,0.722,33,77,0.429,28,58,0.483,5,19,0.263,20,27,0.741
12/23/2014,18,MIL,CHO,L ,101,108,240,39,82,0.476,31,61,0.508,8,21,0.381,15,20,0.75,36,82,0.439,28,61,0.459,8,21,0.381,28,36,0.778
12/23/2014,11,OKC,POR,L ,111,115,265,46,101,0.455,40,82,0.488,6,19,0.316,13,15,0.867,38,91,0.418,21,60,0.35,17,31,0.548,22,24,0.917
12/23/2014,0,ORL,BOS,W ,100,95,240,39,83,0.47,32,65,0.492,7,18,0.389,15,23,0.652,33,85,0.388,26,62,0.419,7,23,0.304,22,29,0.759
12/23/2014,3,PHO,DAL,W ,124,115,240,44,97,0.454,31,64,0.484,13,33,0.394,23,32,0.719,41,88,0.466,32,63,0.508,9,25,0.36,24,29,0.828
12/23/2014,7,WAS,CHI,L ,91,99,240,38,89,0.427,33,80,0.413,5,9,0.556,10,16,0.625,39,85,0.459,34,68,0.5,5,17,0.294,16,24,0.667
12/22/2014,8,CHI,TOR,W ,129,120,240,40,74,0.541,34,62,0.548,6,12,0.5,43,47,0.915,44,100,0.44,35,70,0.5,9,30,0.3,23,32,0.719
12/22/2014,0,CHO,DEN,W ,110,82,240,43,80,0.538,35,61,0.574,8,19,0.421,16,24,0.667,31,82,0.378,29,64,0.453,2,18,0.111,18,24,0.75
12/22/2014,2,DAL,ATL,L ,102,105,240,39,90,0.433,28,62,0.452,11,28,0.393,13,20,0.65,40,81,0.494,33,62,0.532,7,19,0.368,18,27,0.667
12/22/2014,5,GSW,SAC,W ,128,108,240,49,91,0.538,40,66,0.606,9,25,0.36,21,24,0.875,43,90,0.478,35,73,0.479,8,17,0.471,14,21,0.667
12/22/2014,3,HOU,POR,W ,110,95,240,41,87,0.471,28,51,0.549,13,36,0.361,15,20,0.75,34,76,0.447,24,49,0.49,10,27,0.37,17,18,0.944
12/22/2014,15,MEM,UTA,L ,91,97,240,38,86,0.442,31,63,0.492,7,23,0.304,8,9,0.889,34,75,0.453,25,56,0.446,9,19,0.474,20,27,0.741
12/22/2014,8,SAS,LAC,W ,125,118,240,49,77,0.636,36,54,0.667,13,23,0.565,14,22,0.636,43,86,0.5,33,62,0.532,10,24,0.417,22,29,0.759
12/21/2014,2,BRK,DET,W ,110,105,240,40,76,0.526,32,56,0.571,8,20,0.4,22,29,0.759,40,91,0.44,31,64,0.484,9,27,0.333,16,26,0.615
12/21/2014,0,CLE,MEM,W ,105,91,240,46,76,0.605,39,62,0.629,7,14,0.5,6,10,0.6,39,86,0.453,38,70,0.543,1,16,0.063,12,15,0.8
12/21/2014,1,MIA,BOS,W ,100,84,240,37,78,0.474,31,57,0.544,6,21,0.286,20,26,0.769,33,83,0.398,27,60,0.45,6,23,0.261,12,15,0.8
12/21/2014,5,MIN,IND,L ,96,100,240,36,77,0.468,31,66,0.47,5,11,0.455,19,24,0.792,42,84,0.5,36,65,0.554,6,19,0.316,10,14,0.714
12/21/2014,10,OKC,NOP,L ,99,101,240,38,83,0.458,33,63,0.524,5,20,0.25,18,24,0.75,43,90,0.478,36,70,0.514,7,20,0.35,8,10,0.8
12/21/2014,9,ORL,PHI,L ,88,96,240,35,84,0.417,28,61,0.459,7,23,0.304,11,20,0.55,35,82,0.427,29,59,0.492,6,23,0.261,20,25,0.8
12/21/2014,10,SAC,LAL,W ,108,101,240,38,79,0.481,31,56,0.554,7,23,0.304,25,36,0.694,33,87,0.379,23,61,0.377,10,26,0.385,25,30,0.833
12/21/2014,0,TOR,NYK,W ,118,108,240,42,86,0.488,28,53,0.528,14,33,0.424,20,27,0.741,40,82,0.488,35,68,0.515,5,14,0.357,23,26,0.885
12/21/2014,5,WAS,PHO,L ,92,104,240,34,83,0.41,31,69,0.449,3,14,0.214,21,29,0.724,40,78,0.513,34,61,0.557,6,17,0.353,18,25,0.72
12/20/2014,1,CHO,UTA,W ,104,86,240,42,87,0.483,33,65,0.508,9,22,0.409,11,16,0.688,33,85,0.388,25,54,0.463,8,31,0.258,12,15,0.8
12/20/2014,5,DAL,SAS,W ,99,93,240,37,86,0.43,28,60,0.467,9,26,0.346,16,20,0.8,32,77,0.416,29,64,0.453,3,13,0.231,26,26,1
12/20/2014,14,DEN,IND,W ,76,73,240,30,82,0.366,28,66,0.424,2,16,0.125,14,19,0.737,27,88,0.307,20,65,0.308,7,23,0.304,12,17,0.706
12/20/2014,9,HOU,ATL,L ,97,104,240,34,86,0.395,19,43,0.442,15,43,0.349,14,18,0.778,38,74,0.514,28,48,0.583,10,26,0.385,18,24,0.75
12/20/2014,18,LAC,MIL,W ,106,102,240,37,81,0.457,25,55,0.455,12,26,0.462,20,27,0.741,43,81,0.531,35,57,0.614,8,24,0.333,8,15,0.533
12/20/2014,0,NOP,POR,L ,88,114,240,30,85,0.353,27,70,0.386,3,15,0.2,25,28,0.893,48,90,0.533,39,65,0.6,9,25,0.36,9,15,0.6
12/20/2014,6,NYK,PHO,L ,90,99,240,35,88,0.398,28,66,0.424,7,22,0.318,13,16,0.813,35,78,0.449,25,53,0.472,10,25,0.4,19,23,0.826
12/19/2014,8,BOS,MIN,W ,114,98,240,48,85,0.565,40,62,0.645,8,23,0.348,10,14,0.714,42,93,0.452,36,81,0.444,6,12,0.5,8,16,0.5
12/19/2014,9,CLE,BRK,W ,95,91,240,31,77,0.403,22,53,0.415,9,24,0.375,24,29,0.828,37,78,0.474,28,54,0.519,9,24,0.375,8,12,0.667
12/19/2014,5,DEN,LAC,W ,109,106,240,38,80,0.475,27,51,0.529,11,29,0.379,22,30,0.733,39,85,0.459,36,67,0.537,3,18,0.167,25,33,0.758
12/19/2014,1,DET,TOR,L ,100,110,240,41,94,0.436,33,69,0.478,8,25,0.32,10,15,0.667,42,88,0.477,34,61,0.557,8,27,0.296,18,24,0.75
12/19/2014,9,LAL,OKC,L ,103,104,240,41,85,0.482,31,60,0.517,10,25,0.4,11,15,0.733,37,86,0.43,29,65,0.446,8,21,0.381,22,29,0.759
12/19/2014,4,MEM,CHI,L ,97,103,240,37,94,0.394,35,81,0.432,2,13,0.154,21,24,0.875,32,73,0.438,22,47,0.468,10,26,0.385,29,33,0.879
12/19/2014,18,MIA,WAS,L ,103,105,240,40,75,0.533,31,56,0.554,9,19,0.474,14,19,0.737,39,79,0.494,36,65,0.554,3,14,0.214,24,33,0.727
12/19/2014,3,ORL,UTA,L ,94,101,240,37,83,0.446,25,61,0.41,12,22,0.545,8,12,0.667,39,73,0.534,35,62,0.565,4,11,0.364,19,24,0.792
12/19/2014,7,PHI,CHO,L ,91,109,240,32,71,0.451,20,45,0.444,12,26,0.462,15,17,0.882,43,98,0.439,33,74,0.446,10,24,0.417,13,17,0.765
12/19/2014,10,SAS,POR,L ,119,129,315,45,109,0.413,37,89,0.416,8,20,0.4,21,26,0.808,47,110,0.427,34,75,0.453,13,35,0.371,22,23,0.957
12/18/2014,8,CHI,NYK,W ,103,97,240,34,75,0.453,22,52,0.423,12,23,0.522,23,30,0.767,38,82,0.463,32,73,0.438,6,9,0.667,15,19,0.789
12/18/2014,4,GSW,OKC,W ,114,109,240,48,94,0.511,36,63,0.571,12,31,0.387,6,10,0.6,41,86,0.477,30,61,0.492,11,25,0.44,16,24,0.667
12/18/2014,16,HOU,NOP,L ,90,99,240,33,86,0.384,27,61,0.443,6,25,0.24,18,23,0.783,38,82,0.463,33,64,0.516,5,18,0.278,18,22,0.818
12/18/2014,10,SAC,MIL,L ,107,108,240,38,67,0.567,32,53,0.604,6,14,0.429,25,33,0.758,37,75,0.493,24,52,0.462,13,23,0.565,21,27,0.778
12/17/2014,14,BOS,ORL,W ,109,92,240,44,80,0.55,37,61,0.607,7,19,0.368,14,18,0.778,37,85,0.435,32,66,0.485,5,19,0.263,13,15,0.867
12/17/2014,4,CHO,PHO,L ,106,111,240,40,86,0.465,30,62,0.484,10,24,0.417,16,22,0.727,43,82,0.524,34,57,0.596,9,25,0.36,16,21,0.762
12/17/2014,2,CLE,ATL,L ,98,127,240,37,82,0.451,29,52,0.558,8,30,0.267,16,21,0.762,49,76,0.645,33,48,0.688,16,28,0.571,13,16,0.813
12/17/2014,13,DEN,HOU,L ,111,115,265,40,99,0.404,27,69,0.391,13,30,0.433,18,23,0.783,35,85,0.412,27,57,0.474,8,28,0.286,37,48,0.771
12/17/2014,7,DET,DAL,L ,106,117,240,40,89,0.449,27,56,0.482,13,33,0.394,13,19,0.684,40,79,0.506,30,57,0.526,10,22,0.455,27,35,0.771
12/17/2014,7,LAC,IND,W ,102,100,240,34,78,0.436,28,60,0.467,6,18,0.333,28,45,0.622,40,90,0.444,36,71,0.507,4,19,0.211,16,23,0.696
12/17/2014,2,MIA,UTA,L ,87,105,240,27,70,0.386,23,53,0.434,4,17,0.235,29,40,0.725,35,66,0.53,21,41,0.512,14,25,0.56,21,24,0.875
12/17/2014,11,POR,MIL,W ,104,97,240,41,87,0.471,34,64,0.531,7,23,0.304,15,29,0.517,37,77,0.481,30,58,0.517,7,19,0.368,16,22,0.727
12/17/2014,12,SAS,MEM,L ,116,117,315,43,105,0.41,26,70,0.371,17,35,0.486,13,27,0.481,48,107,0.449,38,80,0.475,10,27,0.37,11,14,0.786
12/17/2014,11,TOR,BRK,W ,105,89,240,41,80,0.513,31,60,0.517,10,20,0.5,13,19,0.684,35,81,0.432,26,54,0.481,9,27,0.333,10,22,0.455
12/16/2014,6,BRK,MIA,L ,91,95,240,30,77,0.39,22,49,0.449,8,28,0.286,23,32,0.719,33,72,0.458,24,48,0.5,9,24,0.375,20,26,0.769
12/16/2014,12,MEM,GSW,W ,105,98,240,42,92,0.457,37,78,0.474,5,14,0.357,16,19,0.842,39,95,0.411,30,64,0.469,9,31,0.29,11,12,0.917
12/16/2014,4,NOP,UTA,W ,119,111,240,47,79,0.595,39,63,0.619,8,16,0.5,17,18,0.944,45,90,0.5,40,75,0.533,5,15,0.333,16,19,0.842
12/16/2014,0,NYK,DAL,L ,87,107,240,37,84,0.44,32,63,0.508,5,21,0.238,8,10,0.8,42,83,0.506,27,50,0.54,15,33,0.455,8,8,1
12/16/2014,4,SAC,OKC,L ,92,104,240,36,84,0.429,31,66,0.47,5,18,0.278,15,17,0.882,41,87,0.471,35,67,0.522,6,20,0.3,16,24,0.667
12/16/2014,1,WAS,MIN,W ,109,95,240,43,86,0.5,33,69,0.478,10,17,0.588,13,18,0.722,36,81,0.444,33,73,0.452,3,8,0.375,20,35,0.571
12/15/2014,4,ATL,CHI,W ,93,86,240,36,83,0.434,29,62,0.468,7,21,0.333,14,17,0.824,35,93,0.376,29,64,0.453,6,29,0.207,10,14,0.714
12/15/2014,0,CLE,CHO,W ,97,88,240,38,83,0.458,29,59,0.492,9,24,0.375,12,17,0.706,38,83,0.458,33,67,0.493,5,16,0.313,7,14,0.5
12/15/2014,0,IND,LAL,W ,110,91,240,40,83,0.482,33,66,0.5,7,17,0.412,23,27,0.852,29,88,0.33,19,62,0.306,10,26,0.385,23,29,0.793
12/15/2014,8,LAC,DET,W ,113,91,240,43,80,0.538,31,56,0.554,12,24,0.5,15,20,0.75,35,83,0.422,27,56,0.482,8,27,0.296,13,22,0.591
12/15/2014,1,PHI,BOS,L ,87,105,240,33,93,0.355,29,65,0.446,4,28,0.143,17,21,0.81,38,86,0.442,32,61,0.525,6,25,0.24,23,35,0.657
12/15/2014,9,PHO,MIL,L ,94,96,240,30,75,0.4,18,37,0.486,12,38,0.316,22,27,0.815,35,73,0.479,27,57,0.474,8,16,0.5,18,22,0.818
12/15/2014,2,POR,SAS,W ,108,95,240,41,89,0.461,34,71,0.479,7,18,0.389,19,22,0.864,38,78,0.487,34,67,0.507,4,11,0.364,15,22,0.682
12/15/2014,4,TOR,ORL,W ,95,82,240,37,83,0.446,26,53,0.491,11,30,0.367,10,15,0.667,36,74,0.486,32,59,0.542,4,15,0.267,6,8,0.75
12/14/2014,7,DEN,SAS,L ,91,99,240,34,83,0.41,26,67,0.388,8,16,0.5,15,21,0.714,34,74,0.459,29,58,0.5,5,16,0.313,26,35,0.743
12/14/2014,2,MIA,CHI,L ,75,93,240,28,80,0.35,24,58,0.414,4,22,0.182,15,18,0.833,33,71,0.465,24,53,0.453,9,18,0.5,18,21,0.857
12/14/2014,5,MIN,LAL,L ,94,100,240,38,90,0.422,35,80,0.438,3,10,0.3,15,20,0.75,34,81,0.42,29,64,0.453,5,17,0.294,27,34,0.794
12/14/2014,16,NOP,GSW,L ,122,128,265,47,101,0.465,39,74,0.527,8,27,0.296,20,25,0.8,44,86,0.512,33,62,0.532,11,24,0.458,29,35,0.829
12/14/2014,12,NYK,TOR,L ,90,95,265,29,78,0.372,20,49,0.408,9,29,0.31,23,28,0.821,36,78,0.462,27,54,0.5,9,24,0.375,14,18,0.778
12/14/2014,0,OKC,PHO,W ,112,88,240,39,80,0.488,35,62,0.565,4,18,0.222,30,34,0.882,34,99,0.343,27,68,0.397,7,31,0.226,13,18,0.722
12/14/2014,9,WAS,UTA,W ,93,84,240,41,84,0.488,37,71,0.521,4,13,0.308,7,12,0.583,30,78,0.385,25,61,0.41,5,17,0.294,19,28,0.679
12/13/2014,0,CHO,BRK,L ,87,114,240,31,79,0.392,23,57,0.404,8,22,0.364,17,27,0.63,42,72,0.583,26,49,0.531,16,23,0.696,14,20,0.7
12/13/2014,0,DAL,GSW,L ,98,105,240,36,89,0.404,31,64,0.484,5,25,0.2,21,30,0.7,37,83,0.446,27,51,0.529,10,32,0.313,21,27,0.778
12/13/2014,5,HOU,DEN,W ,108,96,240,39,88,0.443,29,54,0.537,10,34,0.294,20,34,0.588,36,96,0.375,29,68,0.426,7,28,0.25,17,26,0.654
12/13/2014,7,IND,POR,L ,85,95,240,34,88,0.386,30,73,0.411,4,15,0.267,13,16,0.813,40,90,0.444,35,73,0.479,5,17,0.294,10,12,0.833
12/13/2014,13,MIL,LAC,W ,111,106,240,43,76,0.566,36,65,0.554,7,11,0.636,18,24,0.75,39,91,0.429,25,62,0.403,14,29,0.483,14,19,0.737
12/13/2014,15,ORL,ATL,W ,100,99,240,37,74,0.5,27,53,0.509,10,21,0.476,16,21,0.762,35,84,0.417,27,57,0.474,8,27,0.296,21,24,0.875
12/13/2014,7,PHI,MEM,L ,115,120,265,40,82,0.488,29,54,0.537,11,28,0.393,24,34,0.706,45,93,0.484,34,67,0.507,11,26,0.423,19,27,0.704
12/13/2014,10,SAC,DET,L ,90,95,240,33,93,0.355,22,64,0.344,11,29,0.379,13,19,0.684,35,79,0.443,29,59,0.492,6,20,0.3,19,23,0.826
12/12/2014,12,ATL,ORL,W ,87,81,240,29,78,0.372,20,49,0.408,9,29,0.31,20,27,0.741,30,77,0.39,21,51,0.412,9,26,0.346,12,16,0.75
12/12/2014,5,BOS,NYK,L ,95,101,240,37,85,0.435,30,63,0.476,7,22,0.318,14,18,0.778,40,81,0.494,34,65,0.523,6,16,0.375,15,18,0.833
12/12/2014,3,BRK,PHI,W ,88,70,240,36,81,0.444,31,61,0.508,5,20,0.25,11,17,0.647,22,69,0.319,11,41,0.268,11,28,0.393,15,20,0.75
12/12/2014,7,CHI,POR,W ,115,106,240,44,88,0.5,39,73,0.534,5,15,0.333,22,28,0.786,43,88,0.489,31,64,0.484,12,24,0.5,8,11,0.727
12/12/2014,8,MEM,CHO,W ,113,107,290,39,85,0.459,33,72,0.458,6,13,0.462,29,38,0.763,41,98,0.418,35,81,0.432,6,17,0.353,19,27,0.704
12/12/2014,0,MIN,OKC,L ,92,111,240,36,78,0.462,35,71,0.493,1,7,0.143,19,29,0.655,45,88,0.511,39,64,0.609,6,24,0.25,15,20,0.75
12/12/2014,23,NOP,CLE,W ,119,114,240,44,79,0.557,32,51,0.627,12,28,0.429,19,25,0.76,44,89,0.494,36,67,0.537,8,22,0.364,18,23,0.783
12/12/2014,19,PHO,DET,L ,103,105,240,39,83,0.47,29,52,0.558,10,31,0.323,15,19,0.789,40,84,0.476,36,69,0.522,4,15,0.267,21,27,0.778
12/12/2014,11,SAS,LAL,L ,110,112,265,42,90,0.467,30,59,0.508,12,31,0.387,14,21,0.667,44,96,0.458,32,72,0.444,12,24,0.5,12,15,0.8
12/12/2014,1,TOR,IND,W ,106,94,240,38,91,0.418,28,65,0.431,10,26,0.385,20,22,0.909,33,80,0.413,25,58,0.431,8,22,0.364,20,23,0.87
12/12/2014,0,UTA,MIA,L ,95,100,240,34,77,0.442,26,49,0.531,8,28,0.286,19,22,0.864,36,72,0.5,29,52,0.558,7,20,0.35,21,31,0.677
12/12/2014,0,WAS,LAC,W ,104,96,240,39,80,0.488,30,64,0.469,9,16,0.563,17,21,0.81,32,75,0.427,26,55,0.473,6,20,0.3,26,31,0.839
12/11/2014,11,OKC,CLE,W ,103,94,240,38,87,0.437,31,61,0.508,7,26,0.269,20,22,0.909,31,85,0.365,22,57,0.386,9,28,0.321,23,30,0.767
12/11/2014,3,SAC,HOU,L ,109,113,265,39,84,0.464,31,66,0.47,8,18,0.444,23,34,0.676,38,95,0.4,23,51,0.451,15,44,0.341,22,31,0.71
12/10/2014,0,ATL,PHI,W ,95,79,240,38,91,0.418,28,61,0.459,10,30,0.333,9,13,0.692,30,72,0.417,24,47,0.511,6,25,0.24,13,22,0.591
12/10/2014,3,CHI,BRK,W ,105,80,240,37,79,0.468,29,57,0.509,8,22,0.364,23,32,0.719,29,88,0.33,26,74,0.351,3,14,0.214,19,24,0.792
12/10/2014,3,CHO,BOS,W ,96,87,240,35,84,0.417,32,70,0.457,3,14,0.214,23,29,0.793,38,87,0.437,33,64,0.516,5,23,0.217,6,10,0.6
12/10/2014,15,DAL,NOP,W ,112,107,240,44,83,0.53,35,62,0.565,9,21,0.429,15,17,0.882,40,88,0.455,33,70,0.471,7,18,0.389,20,24,0.833
12/10/2014,3,DEN,MIA,W ,102,82,240,38,85,0.447,30,62,0.484,8,23,0.348,18,27,0.667,30,82,0.366,23,60,0.383,7,22,0.318,15,21,0.714
12/10/2014,14,GSW,HOU,W ,105,93,240,40,81,0.494,32,58,0.552,8,23,0.348,17,20,0.85,37,90,0.411,28,55,0.509,9,35,0.257,10,15,0.667
12/10/2014,3,IND,LAC,L ,96,103,240,35,89,0.393,26,62,0.419,9,27,0.333,17,22,0.773,42,88,0.477,35,64,0.547,7,24,0.292,12,14,0.857
12/10/2014,6,MIN,POR,W ,90,82,240,32,81,0.395,31,69,0.449,1,12,0.083,25,33,0.758,31,80,0.388,21,45,0.467,10,35,0.286,10,12,0.833
12/10/2014,5,ORL,WAS,L ,89,91,240,38,84,0.452,31,69,0.449,7,15,0.467,6,9,0.667,41,81,0.506,36,69,0.522,5,12,0.417,4,9,0.444
12/10/2014,9,SAS,NYK,W ,109,95,240,37,73,0.507,27,54,0.5,10,19,0.526,25,30,0.833,37,76,0.487,31,61,0.508,6,15,0.4,15,17,0.882
12/9/2014,2,CLE,TOR,W ,105,101,240,39,79,0.494,30,53,0.566,9,26,0.346,18,21,0.857,42,82,0.512,35,59,0.593,7,23,0.304,10,10,1
12/9/2014,2,DET,POR,L ,86,98,240,34,97,0.351,29,75,0.387,5,22,0.227,13,16,0.813,41,84,0.488,32,63,0.508,9,21,0.429,7,8,0.875
12/9/2014,9,LAL,SAC,W ,98,95,240,38,96,0.396,33,71,0.465,5,25,0.2,17,25,0.68,32,70,0.457,25,55,0.455,7,15,0.467,24,37,0.649
12/9/2014,5,MEM,DAL,W ,114,105,240,41,85,0.482,34,71,0.479,7,14,0.5,25,29,0.862,38,85,0.447,20,45,0.444,18,40,0.45,11,14,0.786
12/9/2014,8,NOP,NYK,W ,104,93,240,40,80,0.5,36,65,0.554,4,15,0.267,20,26,0.769,37,78,0.474,28,59,0.475,9,19,0.474,10,13,0.769
12/9/2014,8,OKC,MIL,W ,114,101,240,41,82,0.5,37,61,0.607,4,21,0.19,28,34,0.824,34,84,0.405,30,63,0.476,4,21,0.19,29,35,0.829
12/9/2014,11,PHO,MIA,L ,97,103,240,37,77,0.481,20,42,0.476,17,35,0.486,6,9,0.667,43,80,0.538,34,63,0.54,9,17,0.529,8,12,0.667
12/9/2014,15,UTA,SAS,W ,100,96,240,40,80,0.5,36,66,0.545,4,14,0.286,16,22,0.727,39,84,0.464,35,64,0.547,4,20,0.2,14,23,0.609
12/8/2014,7,BRK,CLE,L ,88,110,240,36,81,0.444,32,62,0.516,4,19,0.211,12,19,0.632,43,90,0.478,34,65,0.523,9,25,0.36,15,22,0.682
12/8/2014,4,IND,ATL,L ,92,108,240,37,84,0.44,28,57,0.491,9,27,0.333,9,17,0.529,40,77,0.519,31,56,0.554,9,21,0.429,19,27,0.704
12/8/2014,17,LAC,PHO,W ,121,120,265,44,96,0.458,35,65,0.538,9,31,0.29,24,30,0.8,44,91,0.484,28,54,0.519,16,37,0.432,16,20,0.8
12/8/2014,0,MIN,GSW,L ,86,102,240,32,88,0.364,30,77,0.39,2,11,0.182,20,29,0.69,42,91,0.462,37,69,0.536,5,22,0.227,13,14,0.929
12/8/2014,11,SAC,UTA,W ,101,92,240,35,74,0.473,32,66,0.485,3,8,0.375,28,36,0.778,32,79,0.405,29,62,0.468,3,17,0.176,25,37,0.676
12/8/2014,9,TOR,DEN,W ,112,107,265,41,81,0.506,32,48,0.667,9,33,0.273,21,29,0.724,43,104,0.413,33,74,0.446,10,30,0.333,11,15,0.733
12/8/2014,11,WAS,BOS,W ,133,132,290,49,94,0.521,42,78,0.538,7,16,0.438,28,34,0.824,47,102,0.461,38,80,0.475,9,22,0.409,29,32,0.906
12/7/2014,3,ATL,DEN,W ,96,84,240,36,87,0.414,26,60,0.433,10,27,0.37,14,19,0.737,34,93,0.366,28,58,0.483,6,35,0.171,10,13,0.769
12/7/2014,0,BOS,WAS,W ,101,93,240,36,88,0.409,28,71,0.394,8,17,0.471,21,26,0.808,34,93,0.366,23,66,0.348,11,27,0.407,14,21,0.667
12/7/2014,6,DAL,MIL,W ,125,102,240,49,84,0.583,37,53,0.698,12,31,0.387,15,19,0.789,42,84,0.5,38,69,0.551,4,15,0.267,14,17,0.824
12/7/2014,4,DET,OKC,L ,94,96,240,34,76,0.447,27,53,0.509,7,23,0.304,19,28,0.679,39,87,0.448,33,66,0.5,6,21,0.286,12,17,0.706
12/7/2014,1,LAL,NOP,L ,87,104,240,36,90,0.4,31,71,0.437,5,19,0.263,10,15,0.667,43,83,0.518,35,65,0.538,8,18,0.444,10,15,0.667
12/7/2014,5,MEM,MIA,W ,103,87,240,43,73,0.589,35,60,0.583,8,13,0.615,9,11,0.818,39,80,0.488,34,64,0.531,5,16,0.313,4,8,0.5
12/7/2014,4,NYK,POR,L ,99,103,240,41,79,0.519,36,60,0.6,5,19,0.263,12,14,0.857,36,85,0.424,26,57,0.456,10,28,0.357,21,29,0.724
12/6/2014,15,CHI,GSW,L ,102,112,240,36,83,0.434,29,62,0.468,7,21,0.333,23,27,0.852,40,89,0.449,28,59,0.475,12,30,0.4,20,25,0.8
12/6/2014,16,DET,PHI,L ,101,108,265,34,87,0.391,28,64,0.438,6,23,0.261,27,35,0.771,40,87,0.46,33,64,0.516,7,23,0.304,21,30,0.7
12/6/2014,0,HOU,PHO,W ,100,95,240,33,81,0.407,22,54,0.407,11,27,0.407,23,31,0.742,34,93,0.366,27,65,0.415,7,28,0.25,20,26,0.769
12/6/2014,2,LAC,NOP,W ,120,100,240,43,78,0.551,26,46,0.565,17,32,0.531,17,24,0.708,38,80,0.475,30,57,0.526,8,23,0.348,16,25,0.64
12/6/2014,3,SAC,ORL,L ,96,105,240,35,79,0.443,31,64,0.484,4,15,0.267,22,28,0.786,42,83,0.506,33,57,0.579,9,26,0.346,12,14,0.857
12/6/2014,5,SAS,MIN,W ,123,101,240,47,82,0.573,40,64,0.625,7,18,0.389,22,25,0.88,35,83,0.422,29,67,0.433,6,16,0.375,25,32,0.781
12/5/2014,1,BOS,LAL,W ,113,96,240,46,90,0.511,38,70,0.543,8,20,0.4,13,22,0.591,38,92,0.413,32,76,0.421,6,16,0.375,14,19,0.737
12/5/2014,2,BRK,ATL,L ,75,98,240,30,80,0.375,27,62,0.435,3,18,0.167,12,19,0.632,35,81,0.432,22,47,0.468,13,34,0.382,15,24,0.625
12/5/2014,6,CHO,NYK,W ,103,102,240,42,88,0.477,38,70,0.543,4,18,0.222,15,18,0.833,37,79,0.468,27,57,0.474,10,22,0.455,18,22,0.818
12/5/2014,2,DAL,PHO,L ,106,118,240,40,88,0.455,36,69,0.522,4,19,0.211,22,30,0.733,45,80,0.563,32,54,0.593,13,26,0.5,15,17,0.882
12/5/2014,0,MEM,SAS,L ,101,107,240,37,80,0.463,32,68,0.471,5,12,0.417,22,26,0.846,40,84,0.476,26,59,0.441,14,25,0.56,13,16,0.813
12/5/2014,12,MIL,MIA,W ,109,85,240,39,69,0.565,30,53,0.566,9,16,0.563,22,26,0.846,30,68,0.441,23,50,0.46,7,18,0.389,18,27,0.667
12/5/2014,7,MIN,HOU,L ,112,114,265,45,97,0.464,42,87,0.483,3,10,0.3,19,27,0.704,38,78,0.487,26,46,0.565,12,32,0.375,26,31,0.839
12/5/2014,0,PHI,OKC,L ,91,103,240,32,84,0.381,24,56,0.429,8,28,0.286,19,30,0.633,35,71,0.493,26,48,0.542,9,23,0.391,24,31,0.774
12/5/2014,7,SAC,IND,W ,102,101,265,36,83,0.434,34,73,0.466,2,10,0.2,28,40,0.7,36,96,0.375,30,70,0.429,6,26,0.231,23,29,0.793
12/5/2014,2,TOR,CLE,L ,91,105,240,35,86,0.407,27,62,0.435,8,24,0.333,13,20,0.65,41,84,0.488,32,64,0.5,9,20,0.45,14,21,0.667
12/5/2014,1,UTA,ORL,L ,93,98,240,36,79,0.456,28,63,0.444,8,16,0.5,13,21,0.619,37,74,0.5,30,57,0.526,7,17,0.412,17,20,0.85
12/5/2014,7,WAS,DEN,W ,119,89,240,45,85,0.529,38,65,0.585,7,20,0.35,22,27,0.815,31,82,0.378,26,60,0.433,5,22,0.227,22,30,0.733
12/4/2014,1,GSW,NOP,W ,112,85,240,47,100,0.47,37,78,0.474,10,22,0.455,8,17,0.471,37,89,0.416,34,74,0.459,3,15,0.2,8,13,0.615
12/4/2014,12,NYK,CLE,L ,87,90,240,37,88,0.42,29,62,0.468,8,26,0.308,5,6,0.833,32,70,0.457,27,52,0.519,5,18,0.278,21,26,0.808
12/4/2014,1,POR,IND,W ,88,82,240,33,83,0.398,29,62,0.468,4,21,0.19,18,23,0.783,36,91,0.396,31,73,0.425,5,18,0.278,5,8,0.625
12/3/2014,10,BOS,DET,W ,109,102,265,37,93,0.398,24,63,0.381,13,30,0.433,22,27,0.815,37,102,0.363,29,75,0.387,8,27,0.296,20,29,0.69
12/3/2014,8,BRK,SAS,W ,95,93,265,37,90,0.411,28,71,0.394,9,19,0.474,12,18,0.667,36,101,0.356,24,69,0.348,12,32,0.375,9,12,0.75
12/3/2014,15,CHO,CHI,L ,95,102,240,36,90,0.4,34,75,0.453,2,15,0.133,21,23,0.913,37,80,0.463,25,52,0.481,12,28,0.429,16,21,0.762
12/3/2014,1,HOU,MEM,W ,105,96,240,41,93,0.441,31,65,0.477,10,28,0.357,13,20,0.65,39,76,0.513,37,63,0.587,2,13,0.154,16,27,0.593
12/3/2014,0,LAC,ORL,W ,114,86,240,42,78,0.538,30,47,0.638,12,31,0.387,18,25,0.72,33,79,0.418,26,59,0.441,7,20,0.35,13,25,0.52
12/3/2014,3,MIA,ATL,L ,102,112,240,36,64,0.563,30,48,0.625,6,16,0.375,24,32,0.75,40,74,0.541,28,49,0.571,12,25,0.48,20,23,0.87
12/3/2014,7,MIL,DAL,L ,105,107,240,38,73,0.521,31,62,0.5,7,11,0.636,22,32,0.688,42,92,0.457,34,65,0.523,8,27,0.296,15,22,0.682
12/3/2014,14,MIN,PHI,L ,77,85,240,30,84,0.357,27,67,0.403,3,17,0.176,14,17,0.824,32,82,0.39,27,58,0.466,5,24,0.208,16,25,0.64
12/3/2014,10,UTA,TOR,L ,104,123,240,42,87,0.483,34,59,0.576,8,28,0.286,12,15,0.8,45,79,0.57,33,58,0.569,12,21,0.571,21,24,0.875
12/3/2014,5,WAS,LAL,W ,111,95,240,45,93,0.484,39,74,0.527,6,19,0.316,15,19,0.789,33,85,0.388,21,56,0.375,12,29,0.414,17,21,0.81
12/2/2014,2,ATL,BOS,W ,109,105,240,43,82,0.524,32,58,0.552,11,24,0.458,12,14,0.857,41,84,0.488,29,61,0.475,12,23,0.522,11,13,0.846
12/2/2014,14,CHI,DAL,L ,129,132,290,47,103,0.456,39,77,0.506,8,26,0.308,27,34,0.794,47,102,0.461,32,72,0.444,15,30,0.5,23,27,0.852
12/2/2014,12,CLE,MIL,W ,111,108,240,39,73,0.534,33,52,0.635,6,21,0.286,27,38,0.711,45,92,0.489,38,72,0.528,7,20,0.35,11,13,0.846
12/2/2014,4,DEN,POR,L ,103,105,240,41,81,0.506,34,61,0.557,7,20,0.35,14,19,0.737,43,86,0.5,38,64,0.594,5,22,0.227,14,17,0.824
12/2/2014,11,DET,LAL,L ,96,106,240,33,90,0.367,27,69,0.391,6,21,0.286,24,31,0.774,39,81,0.481,29,64,0.453,10,17,0.588,18,24,0.75
12/2/2014,10,GSW,ORL,W ,98,97,240,38,82,0.463,30,55,0.545,8,27,0.296,14,18,0.778,39,87,0.448,33,70,0.471,6,17,0.353,13,14,0.929
12/2/2014,9,NOP,OKC,W ,112,104,240,39,88,0.443,34,71,0.479,5,17,0.294,29,45,0.644,37,84,0.44,30,60,0.5,7,24,0.292,23,27,0.852
12/2/2014,1,NYK,BRK,L ,93,98,240,35,81,0.432,24,53,0.453,11,28,0.393,12,14,0.857,39,89,0.438,33,72,0.458,6,17,0.353,14,20,0.7
12/2/2014,11,PHO,IND,W ,116,99,240,43,86,0.5,31,61,0.508,12,25,0.48,18,26,0.692,41,85,0.482,37,72,0.514,4,13,0.308,13,17,0.765
12/2/2014,2,SAC,TOR,L ,109,117,240,39,75,0.52,36,65,0.554,3,10,0.3,28,37,0.757,44,88,0.5,34,65,0.523,10,23,0.435,19,21,0.905
12/1/2014,10,LAC,MIN,W ,127,101,240,41,80,0.513,26,46,0.565,15,34,0.441,30,36,0.833,35,82,0.427,33,70,0.471,2,12,0.167,29,40,0.725
12/1/2014,2,PHI,SAS,L ,103,109,240,38,89,0.427,26,60,0.433,12,29,0.414,15,25,0.6,36,83,0.434,27,57,0.474,9,26,0.346,28,35,0.8
12/1/2014,6,UTA,DEN,L ,101,103,240,36,84,0.429,29,66,0.439,7,18,0.389,22,30,0.733,41,87,0.471,32,61,0.525,9,26,0.346,12,17,0.706
12/1/2014,0,WAS,MIA,W ,107,86,240,39,72,0.542,29,53,0.547,10,19,0.526,19,24,0.792,33,72,0.458,31,50,0.62,2,22,0.091,18,30,0.6
11/30/2014,8,BOS,SAS,L ,89,111,240,36,87,0.414,30,69,0.435,6,18,0.333,11,15,0.733,41,85,0.482,30,59,0.508,11,26,0.423,18,20,0.9
11/30/2014,3,BRK,CHI,L ,84,102,240,32,86,0.372,30,72,0.417,2,14,0.143,18,24,0.75,34,69,0.493,27,45,0.6,7,24,0.292,27,34,0.794
11/30/2014,3,DET,GSW,L ,93,104,240,33,91,0.363,22,68,0.324,11,23,0.478,16,24,0.667,37,79,0.468,28,58,0.483,9,21,0.429,21,27,0.778
11/30/2014,11,LAL,TOR,W ,129,122,265,47,96,0.49,37,72,0.514,10,24,0.417,25,34,0.735,45,104,0.433,36,70,0.514,9,34,0.265,23,31,0.742
11/30/2014,0,NYK,MIA,L ,79,86,240,31,88,0.352,28,64,0.438,3,24,0.125,14,20,0.7,30,72,0.417,23,49,0.469,7,23,0.304,19,31,0.613
11/30/2014,15,PHO,ORL,L ,90,93,240,34,85,0.4,27,59,0.458,7,26,0.269,15,18,0.833,35,76,0.461,30,61,0.492,5,15,0.333,18,25,0.72
11/30/2014,5,POR,MIN,W ,107,93,240,39,86,0.453,27,53,0.509,12,33,0.364,17,25,0.68,39,90,0.433,37,81,0.457,2,9,0.222,13,20,0.65
11/30/2014,0,SAC,MEM,L ,85,97,240,33,70,0.471,32,59,0.542,1,11,0.091,18,27,0.667,38,79,0.481,35,66,0.53,3,13,0.231,18,28,0.643
11/29/2014,0,ATL,CHO,W ,105,75,240,40,75,0.533,28,52,0.538,12,23,0.522,13,16,0.813,29,88,0.33,24,65,0.369,5,23,0.217,12,16,0.75
11/29/2014,0,CLE,IND,W ,109,97,240,41,78,0.526,34,62,0.548,7,16,0.438,20,32,0.625,35,89,0.393,28,67,0.418,7,22,0.318,20,26,0.769
11/29/2014,1,MIL,HOU,L ,103,117,240,33,74,0.446,27,55,0.491,6,19,0.316,31,35,0.886,44,87,0.506,29,49,0.592,15,38,0.395,14,16,0.875
11/29/2014,9,PHI,DAL,L ,103,110,240,36,85,0.424,30,64,0.469,6,21,0.286,25,31,0.806,40,89,0.449,32,59,0.542,8,30,0.267,22,30,0.733
11/29/2014,0,UTA,LAC,L ,96,112,240,34,75,0.453,27,54,0.5,7,21,0.333,21,33,0.636,45,80,0.563,34,52,0.654,11,28,0.393,11,15,0.733
11/29/2014,2,WAS,NOP,W ,83,80,240,35,76,0.461,30,64,0.469,5,12,0.417,8,12,0.667,30,81,0.37,24,64,0.375,6,17,0.353,14,21,0.667
11/28/2014,1,ATL,NOP,W ,100,91,240,38,76,0.5,33,59,0.559,5,17,0.294,19,22,0.864,36,89,0.404,29,65,0.446,7,24,0.292,12,16,0.75
11/28/2014,10,BOS,CHI,L ,102,109,240,37,92,0.402,31,70,0.443,6,22,0.273,22,29,0.759,37,90,0.411,32,73,0.438,5,17,0.294,30,37,0.811
11/28/2014,6,CHO,GSW,L ,101,106,240,38,87,0.437,32,68,0.471,6,19,0.316,19,23,0.826,42,99,0.424,35,73,0.479,7,26,0.269,15,16,0.938
11/28/2014,0,DEN,PHO,W ,122,97,240,41,88,0.466,33,67,0.493,8,21,0.381,32,36,0.889,33,85,0.388,25,62,0.403,8,23,0.348,23,29,0.793
11/28/2014,7,DET,MIL,L ,88,104,240,34,83,0.41,28,60,0.467,6,23,0.261,14,25,0.56,39,77,0.506,26,48,0.542,13,29,0.448,13,16,0.813
11/28/2014,2,HOU,LAC,L ,85,102,240,32,82,0.39,22,45,0.489,10,37,0.27,11,15,0.733,38,81,0.469,29,56,0.518,9,25,0.36,17,22,0.773
11/28/2014,4,IND,ORL,W ,98,83,240,41,94,0.436,37,78,0.474,4,16,0.25,12,14,0.857,31,70,0.443,24,52,0.462,7,18,0.389,14,16,0.875
11/28/2014,4,LAL,MIN,L ,119,120,240,48,89,0.539,40,68,0.588,8,21,0.381,15,22,0.682,45,79,0.57,35,61,0.574,10,18,0.556,20,24,0.833
11/28/2014,0,OKC,NYK,W ,105,78,240,38,86,0.442,28,62,0.452,10,24,0.417,19,23,0.826,29,75,0.387,27,56,0.482,2,19,0.105,18,24,0.75
11/28/2014,3,POR,MEM,L ,99,112,240,39,97,0.402,31,69,0.449,8,28,0.286,13,18,0.722,45,84,0.536,39,71,0.549,6,13,0.462,16,26,0.615
11/28/2014,3,SAS,SAC,W ,112,104,240,42,82,0.512,30,58,0.517,12,24,0.5,16,20,0.8,38,75,0.507,32,65,0.492,6,10,0.6,22,26,0.846
11/28/2014,1,TOR,DAL,L ,102,106,240,38,91,0.418,24,58,0.414,14,33,0.424,12,16,0.75,40,86,0.465,29,60,0.483,11,26,0.423,15,22,0.682
11/26/2014,2,ATL,TOR,L ,115,126,240,42,82,0.512,32,58,0.552,10,24,0.417,21,24,0.875,42,82,0.512,28,53,0.528,14,29,0.483,28,33,0.848
11/26/2014,2,CHO,POR,L ,97,105,240,41,94,0.436,36,79,0.456,5,15,0.333,10,15,0.667,39,92,0.424,27,65,0.415,12,27,0.444,15,20,0.75
11/26/2014,1,CLE,WAS,W ,113,87,240,38,74,0.514,32,54,0.593,6,20,0.3,31,38,0.816,33,71,0.465,28,58,0.483,5,13,0.385,16,22,0.727
11/26/2014,18,DAL,NYK,W ,109,102,265,38,95,0.4,34,64,0.531,4,31,0.129,29,38,0.763,39,92,0.424,25,64,0.391,14,28,0.5,10,16,0.625
11/26/2014,11,DET,LAC,L ,98,104,240,35,78,0.449,25,51,0.49,10,27,0.37,18,24,0.75,37,78,0.474,25,50,0.5,12,28,0.429,18,19,0.947
11/26/2014,0,HOU,SAC,W ,102,89,240,42,94,0.447,30,59,0.508,12,35,0.343,6,15,0.4,31,71,0.437,26,55,0.473,5,16,0.313,22,28,0.786
11/26/2014,8,LAL,MEM,L ,93,99,240,33,81,0.407,25,62,0.403,8,19,0.421,19,24,0.792,36,80,0.45,31,58,0.534,5,22,0.227,22,25,0.88
11/26/2014,10,MIN,MIL,L ,86,103,240,31,81,0.383,28,67,0.418,3,14,0.214,21,34,0.618,40,85,0.471,35,69,0.507,5,16,0.313,18,19,0.947
11/26/2014,8,OKC,UTA,W ,97,82,240,40,83,0.482,28,57,0.491,12,26,0.462,5,10,0.5,31,70,0.443,28,54,0.519,3,16,0.188,17,28,0.607
11/26/2014,2,ORL,GSW,L ,96,111,240,36,87,0.414,30,67,0.448,6,20,0.3,18,24,0.75,44,85,0.518,32,59,0.542,12,26,0.462,11,19,0.579
11/26/2014,2,PHI,BRK,L ,91,99,240,34,85,0.4,25,61,0.41,9,24,0.375,14,17,0.824,35,71,0.493,27,47,0.574,8,24,0.333,21,28,0.75
11/26/2014,10,PHO,DEN,W ,120,112,240,45,88,0.511,32,63,0.508,13,25,0.52,17,21,0.81,39,90,0.433,31,65,0.477,8,25,0.32,26,34,0.765
11/26/2014,8,SAS,IND,W ,106,100,240,41,74,0.554,36,59,0.61,5,15,0.333,19,29,0.655,40,87,0.46,30,66,0.455,10,21,0.476,10,18,0.556
11/25/2014,0,DEN,CHI,W ,114,109,240,43,85,0.506,35,69,0.507,8,16,0.5,20,27,0.741,35,82,0.427,28,61,0.459,7,21,0.333,32,37,0.865
11/25/2014,8,MIA,GSW,L ,97,114,240,33,85,0.388,23,62,0.371,10,23,0.435,21,27,0.778,43,75,0.573,30,47,0.638,13,28,0.464,15,23,0.652
11/25/2014,10,MIL,DET,W ,98,86,240,39,90,0.433,29,68,0.426,10,22,0.455,10,13,0.769,36,78,0.462,29,58,0.5,7,20,0.35,7,17,0.412
11/25/2014,1,NOP,SAC,L ,89,99,240,33,79,0.418,30,62,0.484,3,17,0.176,20,29,0.69,37,77,0.481,32,63,0.508,5,14,0.357,20,24,0.833
11/25/2014,14,WAS,ATL,L ,102,106,240,36,84,0.429,27,64,0.422,9,20,0.45,21,29,0.724,36,85,0.424,29,60,0.483,7,25,0.28,27,34,0.794
11/24/2014,5,CHO,LAC,L ,92,113,240,31,75,0.413,29,55,0.527,2,20,0.1,28,35,0.8,45,88,0.511,30,56,0.536,15,32,0.469,8,10,0.8
11/24/2014,1,CLE,ORL,W ,106,74,240,42,81,0.519,36,65,0.554,6,16,0.375,16,22,0.727,29,80,0.363,24,63,0.381,5,17,0.294,11,15,0.733
11/24/2014,11,DAL,IND,L ,100,111,240,40,80,0.5,32,56,0.571,8,24,0.333,12,21,0.571,37,77,0.481,24,51,0.471,13,26,0.5,24,36,0.667
11/24/2014,16,HOU,NYK,W ,91,86,240,32,76,0.421,18,40,0.45,14,36,0.389,13,19,0.684,35,76,0.461,29,54,0.537,6,22,0.273,10,15,0.667
11/24/2014,8,PHI,POR,L ,104,114,240,42,84,0.5,42,76,0.553,0,8,0,20,24,0.833,44,89,0.494,37,62,0.597,7,27,0.259,19,23,0.826
11/24/2014,6,TOR,PHO,W ,104,100,240,37,82,0.451,33,65,0.508,4,17,0.235,26,32,0.813,39,84,0.464,25,51,0.49,14,33,0.424,8,11,0.727
11/24/2014,6,UTA,CHI,L ,95,97,240,42,86,0.488,39,77,0.506,3,9,0.333,8,10,0.8,36,72,0.5,27,52,0.519,9,20,0.45,16,23,0.696
11/23/2014,5,BOS,POR,L ,88,94,240,37,95,0.389,32,72,0.444,5,23,0.217,9,12,0.75,37,86,0.43,30,67,0.448,7,19,0.368,13,15,0.867
11/23/2014,13,LAL,DEN,L ,94,101,265,33,89,0.371,30,65,0.462,3,24,0.125,25,34,0.735,34,90,0.378,24,53,0.453,10,37,0.27,23,38,0.605
11/23/2014,4,MEM,LAC,W ,107,91,240,42,85,0.494,35,64,0.547,7,21,0.333,16,23,0.696,32,77,0.416,25,52,0.481,7,25,0.28,20,28,0.714
11/23/2014,19,MIA,CHO,W ,94,93,240,33,66,0.5,22,43,0.512,11,23,0.478,17,19,0.895,37,79,0.468,30,58,0.517,7,21,0.333,12,16,0.75
11/23/2014,2,OKC,GSW,L ,86,91,240,32,90,0.356,29,73,0.397,3,17,0.176,19,27,0.704,33,93,0.355,26,68,0.382,7,25,0.28,18,24,0.75
11/22/2014,5,CLE,TOR,L ,93,110,240,35,81,0.432,32,65,0.492,3,16,0.188,20,29,0.69,32,80,0.4,24,56,0.429,8,24,0.333,38,42,0.905
11/22/2014,7,HOU,DAL,W ,95,92,240,30,82,0.366,15,36,0.417,15,46,0.326,20,23,0.87,35,88,0.398,29,53,0.547,6,35,0.171,16,22,0.727
11/22/2014,7,IND,PHO,L ,83,106,240,31,84,0.369,24,61,0.393,7,23,0.304,14,20,0.7,38,85,0.447,26,54,0.481,12,31,0.387,18,20,0.9
11/22/2014,2,MIL,WAS,L ,100,111,240,36,84,0.429,31,69,0.449,5,15,0.333,23,26,0.885,43,93,0.462,35,75,0.467,8,18,0.444,17,22,0.773
11/22/2014,16,MIN,SAC,L ,101,113,240,37,90,0.411,31,73,0.425,6,17,0.353,21,27,0.778,40,81,0.494,32,55,0.582,8,26,0.308,25,30,0.833
11/22/2014,1,NYK,PHI,W ,91,83,240,33,66,0.5,27,49,0.551,6,17,0.353,19,21,0.905,30,75,0.4,22,49,0.449,8,26,0.308,15,25,0.6
11/22/2014,19,ORL,MIA,L ,92,99,240,35,78,0.449,32,62,0.516,3,16,0.188,19,27,0.704,37,71,0.521,25,45,0.556,12,26,0.462,13,18,0.722
11/22/2014,0,SAS,BRK,W ,99,87,240,41,79,0.519,33,58,0.569,8,21,0.381,9,11,0.818,34,91,0.374,25,64,0.391,9,27,0.333,10,10,1
11/22/2014,8,UTA,NOP,L ,94,106,240,33,71,0.465,28,57,0.491,5,14,0.357,23,29,0.793,42,93,0.452,38,76,0.5,4,17,0.235,18,22,0.818
11/21/2014,1,ATL,DET,W ,99,89,240,38,80,0.475,33,56,0.589,5,24,0.208,18,26,0.692,31,83,0.373,27,62,0.435,4,21,0.19,23,24,0.958
11/21/2014,6,CHO,ORL,L ,100,105,240,42,91,0.462,35,71,0.493,7,20,0.35,9,15,0.6,39,82,0.476,35,66,0.53,4,16,0.25,23,32,0.719
11/21/2014,7,DAL,LAL,W ,140,106,240,51,82,0.622,33,47,0.702,18,35,0.514,20,28,0.714,44,85,0.518,39,72,0.542,5,13,0.385,13,21,0.619
11/21/2014,2,DEN,NOP,W ,117,97,240,43,82,0.524,32,58,0.552,11,24,0.458,20,25,0.8,31,78,0.397,26,62,0.419,5,16,0.313,30,34,0.882
11/21/2014,0,GSW,UTA,W ,101,88,240,41,82,0.5,35,59,0.593,6,23,0.261,13,19,0.684,35,82,0.427,29,65,0.446,6,17,0.353,12,19,0.632
11/21/2014,0,MEM,BOS,W ,117,100,240,48,91,0.527,40,75,0.533,8,16,0.5,13,14,0.929,38,88,0.432,29,61,0.475,9,27,0.333,15,21,0.714
11/21/2014,4,MIN,SAS,L ,92,121,240,37,90,0.411,33,77,0.429,4,13,0.308,14,22,0.636,46,84,0.548,33,63,0.524,13,21,0.619,16,18,0.889
11/21/2014,5,OKC,BRK,L ,92,94,240,38,85,0.447,34,65,0.523,4,20,0.2,12,19,0.632,31,67,0.463,26,52,0.5,5,15,0.333,27,30,0.9
11/21/2014,1,PHI,PHO,L ,96,122,240,36,78,0.462,32,55,0.582,4,23,0.174,20,33,0.606,44,86,0.512,31,55,0.564,13,31,0.419,21,23,0.913
11/21/2014,0,POR,CHI,W ,105,87,240,39,79,0.494,30,63,0.476,9,16,0.563,18,22,0.818,30,83,0.361,22,61,0.361,8,22,0.364,19,28,0.679
11/21/2014,2,TOR,MIL,W ,124,82,240,45,86,0.523,30,61,0.492,15,25,0.6,19,24,0.792,27,74,0.365,21,54,0.389,6,20,0.3,22,32,0.688
11/21/2014,6,WAS,CLE,W ,91,78,240,41,84,0.488,37,74,0.5,4,10,0.4,5,9,0.556,27,75,0.36,21,48,0.438,6,27,0.222,18,23,0.783
11/20/2014,1,MIA,LAC,L ,93,110,240,30,67,0.448,24,41,0.585,6,26,0.231,27,31,0.871,43,77,0.558,30,46,0.652,13,31,0.419,11,17,0.647
11/20/2014,8,SAC,CHI,W ,103,88,240,38,74,0.514,34,68,0.5,4,6,0.667,23,27,0.852,36,84,0.429,31,65,0.477,5,19,0.263,11,16,0.688
11/19/2014,17,BRK,MIL,L ,118,122,315,44,92,0.478,35,61,0.574,9,31,0.29,21,29,0.724,48,108,0.444,43,84,0.512,5,24,0.208,21,28,0.75
11/19/2014,18,CLE,SAS,L ,90,92,240,37,83,0.446,30,65,0.462,7,18,0.389,9,13,0.692,35,74,0.473,30,58,0.517,5,16,0.313,17,25,0.68
11/19/2014,2,DEN,OKC,W ,107,100,240,40,82,0.488,30,53,0.566,10,29,0.345,17,22,0.773,36,79,0.456,26,56,0.464,10,23,0.435,18,25,0.72
11/19/2014,13,DET,PHO,L ,86,88,240,33,87,0.379,26,62,0.419,7,25,0.28,13,19,0.684,37,75,0.493,33,60,0.55,4,15,0.267,10,13,0.769
11/19/2014,10,HOU,LAL,L ,92,98,240,30,74,0.405,15,36,0.417,15,38,0.395,17,23,0.739,37,91,0.407,32,71,0.451,5,20,0.25,19,23,0.826
11/19/2014,10,IND,CHO,W ,88,86,240,35,78,0.449,33,63,0.524,2,15,0.133,16,24,0.667,37,86,0.43,32,72,0.444,5,14,0.357,7,12,0.583
11/19/2014,3,MIN,NYK,W ,115,99,240,44,89,0.494,33,67,0.493,11,22,0.5,16,22,0.727,34,69,0.493,25,53,0.472,9,16,0.563,22,28,0.786
11/19/2014,0,ORL,LAC,L ,90,114,240,34,86,0.395,26,62,0.419,8,24,0.333,14,18,0.778,45,84,0.536,33,63,0.524,12,21,0.571,12,16,0.75
11/19/2014,13,PHI,BOS,L ,90,101,240,34,86,0.395,27,65,0.415,7,21,0.333,15,21,0.714,41,83,0.494,35,63,0.556,6,20,0.3,13,21,0.619
11/19/2014,12,TOR,MEM,W ,96,92,240,38,83,0.458,29,57,0.509,9,26,0.346,11,13,0.846,35,80,0.438,32,70,0.457,3,10,0.3,19,26,0.731
11/19/2014,15,WAS,DAL,L ,102,105,240,37,84,0.44,27,62,0.435,10,22,0.455,18,21,0.857,34,82,0.415,22,54,0.407,12,28,0.429,25,29,0.862
11/18/2014,2,ATL,LAL,L ,109,114,240,41,85,0.482,32,58,0.552,9,27,0.333,18,23,0.783,47,87,0.54,41,70,0.586,6,17,0.353,14,22,0.636
11/18/2014,11,MIL,NYK,W ,117,113,240,43,78,0.551,34,61,0.557,9,17,0.529,22,27,0.815,44,80,0.55,33,55,0.6,11,25,0.44,14,19,0.737
11/18/2014,2,SAC,NOP,L ,100,106,240,38,86,0.442,34,75,0.453,4,11,0.364,20,29,0.69,39,79,0.494,30,55,0.545,9,24,0.375,19,24,0.792
11/18/2014,3,UTA,OKC,W ,98,81,240,35,81,0.432,25,57,0.439,10,24,0.417,18,26,0.692,30,84,0.357,22,61,0.361,8,23,0.348,13,19,0.684
11/17/2014,12,BOS,PHO,L ,114,118,240,45,87,0.517,41,77,0.532,4,10,0.4,20,31,0.645,48,93,0.516,39,72,0.542,9,21,0.429,13,16,0.813
11/17/2014,5,BRK,MIA,L ,83,95,240,29,70,0.414,20,47,0.426,9,23,0.391,16,26,0.615,31,72,0.431,22,45,0.489,9,27,0.333,24,27,0.889
11/17/2014,1,CHO,DAL,L ,80,107,240,32,80,0.4,22,58,0.379,10,22,0.455,6,13,0.462,43,84,0.512,33,56,0.589,10,28,0.357,11,16,0.688
11/17/2014,11,CLE,DEN,L ,97,106,240,34,79,0.43,24,50,0.48,10,29,0.345,19,23,0.826,41,85,0.482,29,54,0.537,12,31,0.387,12,15,0.8
11/17/2014,9,DET,ORL,L ,93,107,240,32,80,0.4,21,56,0.375,11,24,0.458,18,24,0.75,41,79,0.519,28,53,0.528,13,26,0.5,12,15,0.8
11/17/2014,11,LAC,CHI,L ,89,105,240,36,81,0.444,29,58,0.5,7,23,0.304,10,22,0.455,39,80,0.488,29,54,0.537,10,26,0.385,17,25,0.68
11/17/2014,5,MEM,HOU,W ,119,93,240,46,86,0.535,39,69,0.565,7,17,0.412,20,22,0.909,34,78,0.436,26,44,0.591,8,34,0.235,17,21,0.81
11/17/2014,6,POR,NOP,W ,102,93,240,38,76,0.5,31,57,0.544,7,19,0.368,19,23,0.826,38,85,0.447,33,66,0.5,5,19,0.263,12,19,0.632
11/17/2014,0,SAS,PHI,W ,100,75,240,36,81,0.444,26,55,0.473,10,26,0.385,18,21,0.857,27,83,0.325,23,57,0.404,4,26,0.154,17,24,0.708
11/16/2014,1,LAL,GSW,L ,115,136,240,39,99,0.394,36,83,0.434,3,16,0.188,34,43,0.791,46,86,0.535,32,58,0.552,14,28,0.5,30,34,0.882
11/16/2014,4,MIA,MIL,L ,84,91,240,30,73,0.411,19,48,0.396,11,25,0.44,13,22,0.591,35,74,0.473,30,56,0.536,5,18,0.278,16,26,0.615
11/16/2014,2,NYK,DEN,W ,109,93,240,41,76,0.539,35,62,0.565,6,14,0.429,21,27,0.778,32,82,0.39,19,48,0.396,13,34,0.382,16,26,0.615
11/16/2014,4,OKC,HOU,L ,65,69,240,20,68,0.294,17,49,0.347,3,19,0.158,22,28,0.786,23,80,0.288,16,45,0.356,7,35,0.2,16,30,0.533
11/15/2014,3,CHI,IND,L ,90,99,240,35,83,0.422,31,66,0.47,4,17,0.235,16,23,0.696,37,77,0.481,30,59,0.508,7,18,0.389,18,25,0.72
11/15/2014,1,CLE,ATL,W ,127,94,240,49,90,0.544,30,59,0.508,19,31,0.613,10,13,0.769,40,90,0.444,37,68,0.544,3,22,0.136,11,13,0.846
11/15/2014,6,DAL,MIN,W ,131,117,240,52,94,0.553,44,68,0.647,8,26,0.308,19,23,0.826,43,86,0.5,36,69,0.522,7,17,0.412,24,29,0.828
11/15/2014,2,GSW,CHO,W ,112,87,240,45,87,0.517,34,61,0.557,11,26,0.423,11,14,0.786,32,84,0.381,25,67,0.373,7,17,0.412,16,28,0.571
11/15/2014,8,LAC,PHO,W ,120,107,240,36,68,0.529,22,39,0.564,14,29,0.483,34,43,0.791,38,99,0.384,27,69,0.391,11,30,0.367,20,23,0.87
11/15/2014,5,MEM,DET,W ,95,88,240,32,86,0.372,28,71,0.394,4,15,0.267,27,33,0.818,34,82,0.415,24,56,0.429,10,26,0.385,10,17,0.588
11/15/2014,2,POR,BRK,W ,97,87,240,33,78,0.423,22,52,0.423,11,26,0.423,20,27,0.741,35,89,0.393,34,70,0.486,1,19,0.053,16,17,0.941
11/15/2014,8,SAC,SAS,W ,94,91,240,37,86,0.43,37,74,0.5,0,12,0,20,24,0.833,34,80,0.425,27,56,0.482,7,24,0.292,16,18,0.889
11/15/2014,20,TOR,UTA,W ,111,93,240,43,84,0.512,35,63,0.556,8,21,0.381,17,23,0.739,33,75,0.44,28,59,0.475,5,16,0.313,22,30,0.733
11/15/2014,1,WAS,ORL,W ,98,93,240,42,84,0.5,39,74,0.527,3,10,0.3,11,16,0.688,37,78,0.474,30,61,0.492,7,17,0.412,12,18,0.667
11/14/2014,0,ATL,MIA,W ,114,103,240,42,75,0.56,31,47,0.66,11,28,0.393,19,23,0.826,35,74,0.473,25,53,0.472,10,21,0.476,23,25,0.92
11/14/2014,18,BOS,CLE,L ,121,122,240,48,88,0.545,42,68,0.618,6,20,0.3,19,23,0.826,43,85,0.506,35,62,0.565,8,23,0.348,28,37,0.757
11/14/2014,16,HOU,PHI,W ,88,87,240,29,78,0.372,22,44,0.5,7,34,0.206,23,37,0.622,34,80,0.425,27,59,0.458,7,21,0.333,12,18,0.667
11/14/2014,2,IND,DEN,L ,87,108,240,34,84,0.405,26,62,0.419,8,22,0.364,11,22,0.5,43,87,0.494,35,64,0.547,8,23,0.348,14,25,0.56
11/14/2014,3,LAL,SAS,L ,80,93,240,28,75,0.373,26,63,0.413,2,12,0.167,22,31,0.71,33,80,0.413,23,57,0.404,10,23,0.435,17,20,0.85
11/14/2014,0,NOP,MIN,W ,139,91,240,56,84,0.667,41,64,0.641,15,20,0.75,12,16,0.75,29,72,0.403,26,58,0.448,3,14,0.214,30,41,0.732
11/14/2014,3,NYK,UTA,L ,100,102,240,39,82,0.476,34,74,0.459,5,8,0.625,17,20,0.85,36,70,0.514,26,48,0.542,10,22,0.455,20,25,0.8
11/14/2014,12,OKC,DET,L ,89,96,265,38,96,0.396,26,60,0.433,12,36,0.333,1,6,0.167,38,89,0.427,27,58,0.466,11,31,0.355,9,15,0.6
11/14/2014,2,ORL,MIL,W ,101,85,240,35,80,0.438,25,56,0.446,10,24,0.417,21,27,0.778,36,80,0.45,34,61,0.557,2,19,0.105,11,14,0.786
11/14/2014,4,PHO,CHO,L ,95,103,240,37,86,0.43,29,57,0.509,8,29,0.276,13,14,0.929,39,91,0.429,32,75,0.427,7,16,0.438,18,19,0.947
11/13/2014,0,DAL,PHI,W ,123,70,240,41,80,0.513,30,48,0.625,11,32,0.344,30,36,0.833,23,77,0.299,16,50,0.32,7,27,0.259,17,33,0.515
11/13/2014,7,GSW,BRK,W ,107,99,240,41,90,0.456,30,56,0.536,11,34,0.324,14,21,0.667,39,89,0.438,36,73,0.493,3,16,0.188,18,20,0.9
11/13/2014,3,MEM,SAC,W ,111,110,240,39,77,0.506,33,68,0.485,6,9,0.667,27,34,0.794,37,77,0.481,30,64,0.469,7,13,0.538,29,34,0.853
11/13/2014,12,TOR,CHI,L ,93,100,240,35,89,0.393,27,64,0.422,8,25,0.32,15,21,0.714,37,77,0.481,33,62,0.532,4,15,0.267,22,32,0.688
11/12/2014,18,ATL,UTA,W ,100,97,240,39,76,0.513,30,56,0.536,9,20,0.45,13,18,0.722,43,86,0.5,38,63,0.603,5,23,0.217,6,12,0.5
11/12/2014,3,BOS,OKC,L ,94,109,240,37,83,0.446,28,50,0.56,9,33,0.273,11,13,0.846,40,82,0.488,30,58,0.517,10,24,0.417,19,22,0.864
11/12/2014,1,DEN,POR,L ,113,130,240,39,90,0.433,31,67,0.463,8,23,0.348,27,33,0.818,45,88,0.511,29,55,0.527,16,33,0.485,24,29,0.828
11/12/2014,13,MIA,IND,L ,75,81,240,29,68,0.426,20,48,0.417,9,20,0.45,8,18,0.444,30,80,0.375,22,54,0.407,8,26,0.308,13,15,0.867
11/12/2014,4,MIN,HOU,L ,101,113,240,36,81,0.444,30,69,0.435,6,12,0.5,23,30,0.767,43,89,0.483,30,61,0.492,13,28,0.464,14,19,0.737
11/12/2014,11,NOP,LAL,W ,109,102,240,45,82,0.549,37,63,0.587,8,19,0.421,11,18,0.611,35,84,0.417,28,63,0.444,7,21,0.333,25,32,0.781
11/12/2014,35,NYK,ORL,L ,95,97,240,37,86,0.43,29,63,0.46,8,23,0.348,13,14,0.929,33,70,0.471,27,58,0.466,6,12,0.5,25,32,0.781
11/12/2014,6,PHO,BRK,W ,112,104,240,39,81,0.481,31,57,0.544,8,24,0.333,26,29,0.897,35,74,0.473,26,53,0.491,9,21,0.429,25,32,0.781
11/12/2014,12,WAS,DET,W ,107,103,240,40,83,0.482,37,72,0.514,3,11,0.273,24,33,0.727,38,81,0.469,29,59,0.492,9,22,0.409,18,22,0.818
11/11/2014,1,DAL,SAC,W ,106,98,240,38,80,0.475,28,53,0.528,10,27,0.37,20,24,0.833,32,72,0.444,23,53,0.434,9,19,0.474,25,32,0.781
11/11/2014,9,GSW,SAS,L ,100,113,240,38,70,0.543,31,50,0.62,7,20,0.35,17,20,0.85,46,93,0.495,36,68,0.529,10,25,0.4,11,15,0.733
11/11/2014,2,MEM,LAL,W ,107,102,240,41,78,0.526,37,67,0.552,4,11,0.364,21,26,0.808,41,87,0.471,34,65,0.523,7,22,0.318,13,17,0.765
11/11/2014,7,MIL,OKC,W ,85,78,240,33,81,0.407,30,66,0.455,3,15,0.2,16,24,0.667,29,87,0.333,23,67,0.343,6,20,0.3,14,19,0.737
11/11/2014,1,POR,CHO,W ,102,100,240,40,93,0.43,32,68,0.471,8,25,0.32,14,16,0.875,35,75,0.467,28,59,0.475,7,16,0.438,23,27,0.852
11/11/2014,10,TOR,ORL,W ,104,100,240,35,77,0.455,26,56,0.464,9,21,0.429,25,30,0.833,39,81,0.481,27,56,0.482,12,25,0.48,10,16,0.625
11/10/2014,0,CHI,DET,W ,102,91,240,39,88,0.443,32,68,0.471,7,20,0.35,17,20,0.85,34,80,0.425,27,66,0.409,7,14,0.5,16,25,0.64
11/10/2014,4,CLE,NOP,W ,118,111,240,40,81,0.494,27,54,0.5,13,27,0.481,25,30,0.833,41,93,0.441,29,66,0.439,12,27,0.444,17,20,0.85
11/10/2014,10,IND,UTA,W ,97,86,240,39,90,0.433,33,75,0.44,6,15,0.4,13,15,0.867,32,74,0.432,26,53,0.491,6,21,0.286,16,21,0.762
11/10/2014,1,LAC,SAS,L ,85,89,240,33,74,0.446,28,52,0.538,5,22,0.227,14,17,0.824,33,83,0.398,31,64,0.484,2,19,0.105,21,27,0.778
11/10/2014,6,NYK,ATL,L ,85,91,240,36,83,0.434,30,57,0.526,6,26,0.231,7,12,0.583,27,71,0.38,17,44,0.386,10,27,0.37,27,28,0.964
11/9/2014,11,BRK,ORL,W ,104,96,240,40,83,0.482,36,69,0.522,4,14,0.286,20,23,0.87,39,75,0.52,31,60,0.517,8,15,0.533,10,16,0.625
11/9/2014,4,DAL,MIA,L ,96,105,240,35,83,0.422,26,54,0.481,9,29,0.31,17,24,0.708,42,76,0.553,33,53,0.623,9,23,0.391,12,20,0.6
11/9/2014,4,DET,UTA,L ,96,97,240,36,93,0.387,30,70,0.429,6,23,0.261,18,25,0.72,33,72,0.458,27,57,0.474,6,15,0.4,25,35,0.714
11/9/2014,1,LAL,CHO,W ,107,92,240,42,82,0.512,36,65,0.554,6,17,0.353,17,22,0.773,35,79,0.443,32,65,0.492,3,14,0.214,19,27,0.704
11/9/2014,6,OKC,SAC,W ,101,93,240,36,78,0.462,30,60,0.5,6,18,0.333,23,27,0.852,36,80,0.45,30,56,0.536,6,24,0.25,15,22,0.682
11/9/2014,8,PHO,GSW,W ,107,95,240,34,79,0.43,22,49,0.449,12,30,0.4,27,33,0.818,33,69,0.478,22,45,0.489,11,24,0.458,18,21,0.857
11/9/2014,6,POR,DEN,W ,116,100,240,45,100,0.45,29,69,0.42,16,31,0.516,10,14,0.714,36,91,0.396,31,78,0.397,5,13,0.385,23,30,0.767
11/9/2014,1,TOR,PHI,W ,120,88,240,43,76,0.566,36,59,0.61,7,17,0.412,27,30,0.9,33,87,0.379,23,53,0.434,10,34,0.294,12,18,0.667
11/8/2014,9,ATL,NYK,W ,103,96,240,33,81,0.407,24,59,0.407,9,22,0.409,28,36,0.778,40,84,0.476,32,63,0.508,8,21,0.381,8,11,0.727
11/8/2014,4,CHI,BOS,L ,101,106,240,42,92,0.457,34,74,0.459,8,18,0.444,9,15,0.6,42,81,0.519,35,62,0.565,7,19,0.368,15,20,0.75
11/8/2014,8,HOU,GSW,L ,87,98,240,30,86,0.349,20,44,0.455,10,42,0.238,17,21,0.81,39,87,0.448,30,59,0.508,9,28,0.321,11,17,0.647
11/8/2014,4,IND,WAS,L ,90,97,240,33,77,0.429,25,53,0.472,8,24,0.333,16,25,0.64,39,81,0.481,37,70,0.529,2,11,0.182,17,23,0.739
11/8/2014,1,LAC,POR,W ,106,102,240,40,81,0.494,35,69,0.507,5,12,0.417,21,30,0.7,36,80,0.45,26,55,0.473,10,25,0.4,20,25,0.8
11/8/2014,0,MIA,MIN,W ,102,92,240,41,78,0.526,36,65,0.554,5,13,0.385,15,17,0.882,35,87,0.402,31,71,0.437,4,16,0.25,18,23,0.783
11/8/2014,16,MIL,MEM,W ,93,92,240,40,88,0.455,35,70,0.5,5,18,0.278,8,11,0.727,29,82,0.354,26,68,0.382,3,14,0.214,31,34,0.912
11/8/2014,9,SAS,NOP,L ,99,100,240,36,80,0.45,31,62,0.5,5,18,0.278,22,29,0.759,40,85,0.471,32,64,0.5,8,21,0.381,12,14,0.857
11/7/2014,7,BOS,IND,W ,101,98,240,39,85,0.459,30,58,0.517,9,27,0.333,14,16,0.875,40,88,0.455,35,69,0.507,5,19,0.263,13,13,1
11/7/2014,2,BRK,NYK,W ,110,99,240,38,74,0.514,24,50,0.48,14,24,0.583,20,26,0.769,37,90,0.411,29,71,0.408,8,19,0.421,17,21,0.81
11/7/2014,13,CHO,ATL,W ,122,119,290,48,97,0.495,42,76,0.553,6,21,0.286,20,27,0.741,43,93,0.462,30,60,0.5,13,33,0.394,20,26,0.769
11/7/2014,1,DEN,CLE,L ,101,110,240,40,85,0.471,29,56,0.518,11,29,0.379,10,15,0.667,40,84,0.476,34,61,0.557,6,23,0.261,24,33,0.727
11/7/2014,4,DET,MIL,W ,98,95,240,37,75,0.493,26,52,0.5,11,23,0.478,13,24,0.542,36,77,0.468,31,57,0.544,5,20,0.25,18,23,0.783
11/7/2014,2,OKC,MEM,L ,89,91,240,37,79,0.468,25,54,0.463,12,25,0.48,3,11,0.273,34,81,0.42,25,63,0.397,9,18,0.5,14,17,0.824
11/7/2014,17,ORL,MIN,W ,112,103,265,46,91,0.505,41,81,0.506,5,10,0.5,15,19,0.789,40,93,0.43,36,75,0.48,4,18,0.222,19,25,0.76
11/7/2014,7,PHI,CHI,L ,115,118,240,43,91,0.473,31,61,0.508,12,30,0.4,17,25,0.68,40,78,0.513,28,54,0.519,12,24,0.5,26,34,0.765
11/7/2014,5,PHO,SAC,L ,112,114,290,42,98,0.429,32,67,0.478,10,31,0.323,18,25,0.72,39,91,0.429,36,75,0.48,3,16,0.188,33,39,0.846
11/7/2014,0,TOR,WAS,W ,103,84,240,35,80,0.438,26,58,0.448,9,22,0.409,24,31,0.774,30,83,0.361,27,64,0.422,3,19,0.158,21,32,0.656
11/7/2014,1,UTA,DAL,L ,82,105,240,29,68,0.426,20,40,0.5,9,28,0.321,15,19,0.789,42,88,0.477,33,64,0.516,9,24,0.375,12,14,0.857
11/6/2014,0,HOU,SAS,W ,98,81,240,34,72,0.472,24,45,0.533,10,27,0.37,20,33,0.606,31,90,0.344,29,70,0.414,2,20,0.1,17,19,0.895
11/6/2014,11,POR,DAL,W ,108,87,240,40,77,0.519,28,47,0.596,12,30,0.4,16,19,0.842,33,90,0.367,28,67,0.418,5,23,0.217,16,16,1
11/5/2014,2,BOS,TOR,L ,107,110,240,40,78,0.513,30,52,0.577,10,26,0.385,17,18,0.944,42,87,0.483,35,71,0.493,7,16,0.438,19,23,0.826
11/5/2014,12,BRK,MIN,L ,91,98,240,36,82,0.439,28,61,0.459,8,21,0.381,11,17,0.647,37,90,0.411,30,73,0.411,7,17,0.412,17,22,0.773
11/5/2014,14,CHO,MIA,W ,96,89,240,35,82,0.427,30,64,0.469,5,18,0.278,21,29,0.724,30,77,0.39,26,55,0.473,4,22,0.182,25,31,0.806
11/5/2014,4,DET,NYK,W ,98,95,240,32,87,0.368,21,64,0.328,11,23,0.478,23,33,0.697,39,90,0.433,30,70,0.429,9,20,0.45,8,10,0.8
11/5/2014,4,GSW,LAC,W ,121,104,240,43,74,0.581,28,49,0.571,15,25,0.6,20,20,1,38,82,0.463,31,63,0.492,7,19,0.368,21,27,0.778
11/5/2014,10,MIL,CHI,L ,86,95,240,33,89,0.371,30,74,0.405,3,15,0.2,17,20,0.85,34,73,0.466,29,57,0.509,5,16,0.313,22,30,0.733
11/5/2014,15,PHI,ORL,L ,89,91,240,33,77,0.429,25,52,0.481,8,25,0.32,15,23,0.652,39,88,0.443,36,68,0.529,3,20,0.15,10,12,0.833
11/5/2014,7,PHO,MEM,L ,91,102,240,32,69,0.464,24,48,0.5,8,21,0.381,19,21,0.905,40,80,0.5,31,63,0.492,9,17,0.529,13,17,0.765
11/5/2014,2,SAC,DEN,W ,131,109,240,42,76,0.553,34,56,0.607,8,20,0.4,39,50,0.78,37,82,0.451,28,54,0.519,9,28,0.321,26,31,0.839
11/5/2014,2,SAS,ATL,W ,94,92,240,31,69,0.449,26,52,0.5,5,17,0.294,27,38,0.711,38,92,0.413,30,67,0.448,8,25,0.32,8,11,0.727
11/5/2014,2,UTA,CLE,W ,102,100,240,39,77,0.506,32,56,0.571,7,21,0.333,17,22,0.773,30,72,0.417,24,56,0.429,6,16,0.375,34,40,0.85
11/5/2014,10,WAS,IND,W ,96,94,265,34,91,0.374,27,74,0.365,7,17,0.412,21,23,0.913,35,90,0.389,27,63,0.429,8,27,0.296,16,20,0.8
11/4/2014,20,CHI,ORL,W ,98,90,240,35,75,0.467,28,60,0.467,7,15,0.467,21,27,0.778,38,88,0.432,32,74,0.432,6,14,0.429,8,14,0.571
11/4/2014,5,IND,MIL,L ,81,87,240,31,78,0.397,25,54,0.463,6,24,0.25,13,22,0.591,37,83,0.446,30,62,0.484,7,21,0.333,6,7,0.857
11/4/2014,4,LAL,PHO,L ,106,112,240,35,88,0.398,29,72,0.403,6,16,0.375,30,41,0.732,41,91,0.451,35,73,0.479,6,18,0.333,24,31,0.774
11/4/2014,9,MIA,HOU,L ,91,108,240,31,74,0.419,19,46,0.413,12,28,0.429,17,27,0.63,35,68,0.515,18,31,0.581,17,37,0.459,21,27,0.778
11/4/2014,6,NOP,CHO,W ,100,91,240,38,81,0.469,33,63,0.524,5,18,0.278,19,19,1,37,80,0.463,31,59,0.525,6,21,0.286,11,13,0.846
11/4/2014,2,NYK,WAS,L ,83,98,240,30,81,0.37,22,66,0.333,8,15,0.533,15,19,0.789,39,80,0.488,31,62,0.5,8,18,0.444,12,19,0.632
11/4/2014,16,POR,CLE,W ,101,82,240,37,75,0.493,29,50,0.58,8,25,0.32,19,25,0.76,31,85,0.365,22,64,0.344,9,21,0.429,11,14,0.786
11/4/2014,9,TOR,OKC,W ,100,88,240,32,81,0.395,24,50,0.48,8,31,0.258,28,33,0.848,34,65,0.523,28,44,0.636,6,21,0.286,14,25,0.56
11/3/2014,2,BRK,OKC,W ,116,85,240,44,84,0.524,33,61,0.541,11,23,0.478,17,19,0.895,32,82,0.39,24,59,0.407,8,23,0.348,13,21,0.619
11/3/2014,5,DAL,BOS,W ,118,113,240,44,82,0.537,30,57,0.526,14,25,0.56,16,20,0.8,45,102,0.441,34,71,0.479,11,31,0.355,12,16,0.75
11/3/2014,13,DEN,SAC,L ,105,110,240,36,93,0.387,31,69,0.449,5,24,0.208,28,33,0.848,34,81,0.42,32,72,0.444,2,9,0.222,40,47,0.851
11/3/2014,8,LAC,UTA,W ,107,101,240,41,81,0.506,31,58,0.534,10,23,0.435,15,17,0.882,36,77,0.468,26,50,0.52,10,27,0.37,19,24,0.792
11/3/2014,2,MEM,NOP,W ,93,81,240,31,76,0.408,27,62,0.435,4,14,0.286,27,37,0.73,29,86,0.337,25,62,0.403,4,24,0.167,19,29,0.655
11/3/2014,8,PHI,HOU,L ,93,104,240,33,74,0.446,22,52,0.423,11,22,0.5,16,23,0.696,32,75,0.427,16,41,0.39,16,34,0.471,24,30,0.8
11/2/2014,5,LAC,SAC,L ,92,98,240,33,88,0.375,24,57,0.421,9,31,0.29,17,21,0.81,34,68,0.5,31,58,0.534,3,10,0.3,27,33,0.818
11/2/2014,2,MIA,TOR,W ,107,102,240,35,70,0.5,26,46,0.565,9,24,0.375,28,38,0.737,37,79,0.468,33,63,0.524,4,16,0.25,24,39,0.615
11/2/2014,22,NYK,CHO,W ,96,93,240,39,78,0.5,31,62,0.5,8,16,0.5,10,17,0.588,33,70,0.471,27,55,0.491,6,15,0.4,21,29,0.724
11/2/2014,13,POR,GSW,L ,90,95,240,37,92,0.402,30,65,0.462,7,27,0.259,9,14,0.643,36,81,0.444,30,62,0.484,6,19,0.316,17,21,0.81
11/1/2014,0,ATL,IND,W ,102,92,240,35,69,0.507,28,49,0.571,7,20,0.35,25,33,0.758,31,81,0.383,19,49,0.388,12,32,0.375,18,21,0.857
11/1/2014,4,CHO,MEM,L ,69,71,240,26,72,0.361,22,58,0.379,4,14,0.286,13,18,0.722,29,80,0.363,26,69,0.377,3,11,0.273,10,13,0.769
11/1/2014,5,DET,BRK,L ,90,102,240,32,76,0.421,31,59,0.525,1,17,0.059,25,35,0.714,42,87,0.483,35,61,0.574,7,26,0.269,11,13,0.846
11/1/2014,8,GSW,LAL,W ,127,104,240,46,83,0.554,35,60,0.583,11,23,0.478,24,28,0.857,41,88,0.466,37,74,0.5,4,14,0.286,18,25,0.72
11/1/2014,0,HOU,BOS,W ,104,90,240,32,76,0.421,20,42,0.476,12,34,0.353,28,40,0.7,37,98,0.378,36,73,0.493,1,25,0.04,15,18,0.833
11/1/2014,15,MIN,CHI,L ,105,106,240,38,85,0.447,34,73,0.466,4,12,0.333,25,31,0.806,33,69,0.478,24,46,0.522,9,23,0.391,31,40,0.775
11/1/2014,5,NOP,DAL,L ,104,109,240,38,89,0.427,31,70,0.443,7,19,0.368,21,28,0.75,46,89,0.517,40,64,0.625,6,25,0.24,11,19,0.579
11/1/2014,0,OKC,DEN,W ,102,91,240,37,80,0.463,31,60,0.517,6,20,0.3,22,31,0.71,35,80,0.438,28,54,0.519,7,26,0.269,14,20,0.7
11/1/2014,9,ORL,TOR,L ,95,108,240,38,81,0.469,31,61,0.508,7,20,0.35,12,24,0.5,33,83,0.398,29,62,0.468,4,21,0.19,38,48,0.792
11/1/2014,15,PHI,MIA,L ,96,114,240,35,67,0.522,28,44,0.636,7,23,0.304,19,26,0.731,41,83,0.494,29,59,0.492,12,24,0.5,20,29,0.69
11/1/2014,3,UTA,PHO,W ,118,91,240,42,88,0.477,35,62,0.565,7,26,0.269,27,33,0.818,36,87,0.414,29,56,0.518,7,31,0.226,12,15,0.8
11/1/2014,0,WAS,MIL,W ,108,97,240,40,73,0.548,36,60,0.6,4,13,0.308,24,33,0.727,34,80,0.425,25,58,0.431,9,22,0.409,20,24,0.833
10/31/2014,12,CHI,CLE,L ,108,114,265,41,90,0.456,28,59,0.475,13,31,0.419,13,17,0.765,41,104,0.394,38,89,0.427,3,15,0.2,29,33,0.879
10/31/2014,4,IND,MEM,L ,89,97,240,34,74,0.459,26,53,0.491,8,21,0.381,13,16,0.813,35,79,0.443,28,60,0.467,7,19,0.368,20,27,0.741
10/31/2014,5,LAL,LAC,L ,111,118,240,42,82,0.512,35,62,0.565,7,20,0.35,20,28,0.714,34,71,0.479,22,38,0.579,12,33,0.364,38,44,0.864
10/31/2014,10,MIL,PHI,W ,93,81,240,36,88,0.409,27,64,0.422,9,24,0.375,12,21,0.571,32,86,0.372,27,63,0.429,5,23,0.217,12,22,0.545
10/31/2014,1,PHO,SAS,W ,94,89,240,35,87,0.402,33,69,0.478,2,18,0.111,22,26,0.846,32,78,0.41,24,53,0.453,8,25,0.32,17,23,0.739
10/31/2014,10,SAC,POR,W ,103,94,240,34,81,0.42,30,71,0.423,4,10,0.4,31,35,0.886,34,83,0.41,25,57,0.439,9,26,0.346,17,19,0.895
10/30/2014,9,CLE,NYK,L ,90,95,240,32,70,0.457,23,46,0.5,9,24,0.375,17,20,0.85,37,69,0.536,31,57,0.544,6,12,0.5,15,18,0.833
10/30/2014,0,DAL,UTA,W ,120,102,240,47,85,0.553,39,64,0.609,8,21,0.381,18,23,0.783,36,83,0.434,22,48,0.458,14,35,0.4,16,18,0.889
10/30/2014,5,LAC,OKC,W ,93,90,240,34,87,0.391,27,57,0.474,7,30,0.233,18,25,0.72,28,65,0.431,22,44,0.5,6,21,0.286,28,34,0.824
10/30/2014,13,MIN,DET,W ,97,91,240,37,76,0.487,33,66,0.5,4,10,0.4,19,28,0.679,38,91,0.418,31,70,0.443,7,21,0.333,8,13,0.615
10/30/2014,7,ORL,WAS,L ,98,105,240,37,72,0.514,31,57,0.544,6,15,0.4,18,24,0.75,39,80,0.488,32,67,0.478,7,13,0.538,20,26,0.769
10/29/2014,1,BOS,BRK,W ,121,105,240,49,88,0.557,41,66,0.621,8,22,0.364,15,23,0.652,39,80,0.488,32,61,0.525,7,19,0.368,20,26,0.769
10/29/2014,7,CHO,MIL,W ,108,106,265,41,101,0.406,35,80,0.438,6,21,0.286,20,29,0.69,39,80,0.488,32,66,0.485,7,14,0.5,21,24,0.875
10/29/2014,18,DEN,DET,W ,89,79,240,30,85,0.353,24,61,0.393,6,24,0.25,23,31,0.742,31,84,0.369,25,58,0.431,6,26,0.231,11,19,0.579
10/29/2014,9,IND,PHI,W ,103,91,240,38,81,0.469,30,56,0.536,8,25,0.32,19,28,0.679,34,89,0.382,28,68,0.412,6,21,0.286,17,30,0.567
10/29/2014,7,MEM,MIN,W ,105,101,240,43,82,0.524,39,67,0.582,4,15,0.267,15,20,0.75,39,86,0.453,33,74,0.446,6,12,0.5,17,23,0.739
10/29/2014,16,MIA,WAS,W ,107,95,240,39,81,0.481,30,53,0.566,9,28,0.321,20,23,0.87,36,75,0.48,30,56,0.536,6,19,0.316,17,24,0.708
10/29/2014,1,NYK,CHI,L ,80,104,240,31,85,0.365,28,68,0.412,3,17,0.176,15,17,0.882,36,71,0.507,29,47,0.617,7,24,0.292,25,30,0.833
10/29/2014,0,PHO,LAL,W ,119,99,240,45,82,0.549,29,50,0.58,16,32,0.5,13,18,0.722,37,86,0.43,33,73,0.452,4,13,0.308,21,25,0.84
10/29/2014,11,POR,OKC,W ,106,89,240,39,87,0.448,28,58,0.483,11,29,0.379,17,22,0.773,33,81,0.407,31,65,0.477,2,16,0.125,21,26,0.808
10/29/2014,15,SAC,GSW,L ,77,95,240,24,78,0.308,21,60,0.35,3,18,0.167,26,35,0.743,33,75,0.44,27,48,0.563,6,27,0.222,23,32,0.719
10/29/2014,2,TOR,ATL,W ,109,102,240,37,90,0.411,29,64,0.453,8,26,0.308,27,33,0.818,40,80,0.5,27,58,0.466,13,22,0.591,9,17,0.529
10/29/2014,7,UTA,HOU,L ,93,104,240,38,81,0.469,35,63,0.556,3,18,0.167,14,17,0.824,40,77,0.519,26,50,0.52,14,27,0.519,10,14,0.714
10/28/2014,2,LAL,HOU,L ,90,108,240,28,79,0.354,25,69,0.362,3,10,0.3,31,39,0.795,31,73,0.425,19,44,0.432,12,29,0.414,34,50,0.68
10/28/2014,7,NOP,ORL,W ,101,84,240,41,101,0.406,37,84,0.44,4,17,0.235,15,31,0.484,32,84,0.381,28,73,0.384,4,11,0.364,16,21,0.762
10/28/2014,18,SAS,DAL,W ,101,100,240,37,70,0.529,23,42,0.548,14,28,0.5,13,16,0.813,38,78,0.487,30,57,0.526,8,21,0.381,16,19,0.842
